"Abra"	["Karrablast","Mothim","Heracross","Crustle","Nincada","Shuckle","Yanmega","Durant","Vikavolt","Whirlipede"]
"Kadabra"	["Illumise","Masquerain","Scatterbug","Skorupi","Wormadam","Pinsir","Volcarona","Ledyba","Venomoth","Spinarak"]
"Alakazam"	["Golisopod","Ribombee","Beedrill","Vikavolt","Anorith","Armaldo","Shuckle","Cascoon","Spewpa","Pinsir"]
"Drowzee"	["Golisopod","Ribombee","Frosmoth","Venipede","Swadloon","Scizor","Karrablast","Wimpod","Venonat","Shuckle"]
"Hypno"	["Kakuna","Illumise","Burmy","Vespiquen","Blipbug","Wormadam","Nincada","Ribombee","Yanma","Buzzwole"]
"Exeggcute"	["Shelmet","Araquanid","Ariados","Yanmega","Beautifly","Pheromosa","Golisopod","Pinsir","Nincada","Spinarak"]
"Exeggutor"	["Combee","Kricketot","Larvesta","Scolipede","Cascoon","Crustle","Shelmet","Nincada","Surskit","Pheromosa"]
"Mewtwo"	["Karrablast","Cutiefly","Silcoon","Vespiquen","Ledian","Swadloon","Vikavolt","Scatterbug","Spinarak","Wimpod"]
"Mew"	["Surskit","Wormadam","Scyther","Yanmega","Grubbin","Leavanny","Whirlipede","Volbeat","Butterfree","Ninjask"]
"Espeon"	["Metapod","Ledian","Dewpider","Burmy","Whirlipede","Dustox","Cutiefly","Beedrill","Pineco","Escavalier"]
"Unown"	["Burmy","Durant","Vikavolt","Scatterbug","Grubbin","Snom","Venonat","Dustox","Scizor","Metapod"]
"Wobbuffet"	["Mothim","Scizor","Butterfree","Wurmple","Weedle","Genesect","Volcarona","Leavanny","Dustox","Yanma"]
"Girafarig"	["Buzzwole","Nincada","Paras","Snom","Golisopod","Scatterbug","Larvesta","Dewpider","Escavalier","Illumise"]
"Celebi"	["Yanmega","Galvantula","Wimpod","Weedle","Sewaddle","Spewpa","Scyther","Kricketune","Escavalier","Vivillon"]
"Nuzleaf"	["Charjabug","Blipbug","Whirlipede","Kakuna","Sewaddle","Scizor","Centiskorch","Buzzwole","Surskit","Scyther"]
"Shiftry"	["Cutiefly","Vivillon","Leavanny","Venipede","Combee","Volcarona","Mothim","Masquerain","Scyther","Pineco"]
"Spoink"	["Combee","Golisopod","Snom","Orbeetle","Vivillon","Venonat","Dustox","Scyther","Caterpie","Pinsir"]
"Grumpig"	["Sewaddle","Volcarona","Ariados","Nincada","Spewpa","Dottler","Dustox","Skorupi","Mothim","Vikavolt"]
"Cacturne"	["Beautifly","Joltik","Galvantula","Durant","Araquanid","Parasect","Butterfree","Ariados","Ledyba","Combee"]
"Chimecho"	["Karrablast","Wormadam","Vikavolt","Weedle","Spewpa","Grubbin","Galvantula","Cutiefly","Yanmega","Ribombee"]
"Wynaut"	["Cascoon","Grubbin","Snom","Vikavolt","Butterfree","Venipede","Ledyba","Dustox","Larvesta","Ledian"]
"Deoxys"	["Escavalier","Galvantula","Blipbug","Volcarona","Beedrill","Charjabug","Nincada","Joltik","Whirlipede","Venonat"]
"Chingling"	["Accelgor","Spinarak","Scyther","Armaldo","Surskit","Araquanid","Beedrill","Crustle","Blipbug","Anorith"]
"Uxie"	["Ribombee","Swadloon","Scatterbug","Anorith","Forretress","Dottler","Volbeat","Beedrill","Cutiefly","Galvantula"]
"Mesprit"	["Heracross","Scyther","Burmy","Joltik","Shelmet","Dewpider","Kricketune","Snom","Shuckle","Cutiefly"]
"Azelf"	["Venipede","Wormadam","Spewpa","Kricketot","Araquanid","Wimpod","Ariados","Vivillon","Buzzwole","Heracross"]
"Cresselia"	["Wurmple","Metapod","Caterpie","Scatterbug","Vivillon","Snom","Kricketune","Ledian","Grubbin","Scyther"]
"Munna"	["Pineco","Butterfree","Pheromosa","Forretress","Wimpod","Shuckle","Burmy","Venomoth","Shelmet","Wormadam"]
"Musharna"	["Pineco","Cascoon","Dewpider","Ariados","Paras","Skorupi","Ledyba","Genesect","Volcarona","Scizor"]
"Gothita"	["Frosmoth","Karrablast","Skorupi","Ledian","Durant","Scizor","Dottler","Weedle","Ledyba","Venonat"]
"Gothorita"	["Forretress","Paras","Scyther","Crustle","Pheromosa","Silcoon","Ribombee","Buzzwole","Nincada","Spinarak"]
"Gothitelle"	["Butterfree","Pinsir","Parasect","Dustox","Mothim","Ariados","Accelgor","Centiskorch","Orbeetle","Frosmoth"]
"Solosis"	["Durant","Ledian","Butterfree","Caterpie","Dwebble","Escavalier","Grubbin","Scyther","Dottler","Armaldo"]
"Duosion"	["Ninjask","Shuckle","Weedle","Yanma","Beautifly","Metapod","Masquerain","Karrablast","Leavanny","Orbeetle"]
"Reuniclus"	["Leavanny","Dewpider","Grubbin","Venomoth","Illumise","Wimpod","Durant","Buzzwole","Venonat","Escavalier"]
"Elgyem"	["Whirlipede","Snom","Karrablast","Wimpod","Venomoth","Scizor","Caterpie","Nincada","Durant","Yanmega"]
"Beheeyem"	["Ribombee","Shelmet","Genesect","Masquerain","Ledyba","Cascoon","Swadloon","Escavalier","Vivillon","Snom"]
"Meloetta"	["Volcarona","Crustle","Kakuna","Kricketune","Pinsir","Burmy","Scolipede","Butterfree","Surskit","Whirlipede"]
"Espurr"	["Scolipede","Shuckle","Yanma","Surskit","Wimpod","Centiskorch","Joltik","Scyther","Accelgor","Venonat"]
"Meowstic"	["Araquanid","Skorupi","Charjabug","Joltik","Spewpa","Ribombee","Snom","Blipbug","Vivillon","Anorith"]
"Inkay"	["Whirlipede","Ledyba","Volbeat","Vikavolt","Venomoth","Wormadam","Buzzwole","Dwebble","Orbeetle","Ledian"]
"Malamar"	["Leavanny","Escavalier","Volbeat","Ribombee","Metapod","Snom","Kricketot","Spinarak","Skorupi","Pheromosa"]
"Oranguru"	["Kricketot","Ledian","Genesect","Forretress","Ninjask","Golisopod","Karrablast","Nincada","Dwebble","Ribombee"]
"Cosmog"	["Skorupi","Mothim","Burmy","Frosmoth","Larvesta","Swadloon","Metapod","Kricketot","Buzzwole","Caterpie"]
"Cosmoem"	["Wurmple","Sewaddle","Anorith","Spewpa","Buzzwole","Heracross","Scatterbug","Durant","Golisopod","Frosmoth"]
"Necrozma"	["Orbeetle","Venomoth","Dottler","Pheromosa","Golisopod","Spewpa","Leavanny","Dwebble","Genesect","Frosmoth"]
"Hatenna"	["Masquerain","Spewpa","Venomoth","Beedrill","Venipede","Whirlipede","Volcarona","Wurmple","Ledyba","Yanma"]
"Hattrem"	["Araquanid","Masquerain","Metapod","Wurmple","Durant","Charjabug","Spewpa","Dwebble","Mothim","Whirlipede"]
"Indeedee"	["Accelgor","Vikavolt","Grubbin","Forretress","Leavanny","Sewaddle","Cutiefly","Volcarona","Weedle","Venonat"]
"Zarude"	["Butterfree","Scyther","Escavalier","Wimpod","Masquerain","Genesect","Pinsir","Leavanny","Dewpider","Venomoth"]
"Calyrex"	["Blipbug","Swadloon","Ninjask","Sizzlipede","Heracross","Parasect","Yanmega","Orbeetle","Joltik","Pheromosa"]
"Kingdra"	["Appletun","Eternatus","Flygon","Deino","Tyrunt","Rayquaza","Gabite","Noivern","Tyrantrum","Gible"]
"Palkia"	["Dragapult","Kyurem","Vibrava","Naganadel","Shelgon","Bagon","Dracozolt","Gabite","Salamence","Haxorus"]
"Dracovish"	["Rayquaza","Latios","Dreepy","Goomy","Altaria","Naganadel","Zekrom","Kommo-o","Axew","Tyrunt"]
"Squirtle"	["Regieleki","Boltund","Toxtricity","Helioptile","Xurkitree","Electrode","Luxray","Mareep","Charjabug","Pikachu"]
"Wartortle"	["Boltund","Tynamo","Dracozolt","Jolteon","Voltorb","Blitzle","Eelektrik","Pikachu","Magneton","Manectric"]
"Blastoise"	["Luxio","Electrode","Pachirisu","Pincurchin","Shinx","Dedenne","Yamper","Toxtricity","Thundurus","Xurkitree"]
"Pidgey"	["Stunfisk","Arctozolt","Luxray","Charjabug","Helioptile","Flaaffy","Zeraora","Minun","Pichu","Mareep"]
"Pidgeotto"	["Joltik","Zebstrika","Jolteon","Electivire","Raichu","Zekrom","Pichu","Toxel","Plusle","Togedemaru"]
"Pidgeot"	["Electivire","Pichu","Boltund","Toxel","Helioptile","Zekrom","Magnezone","Chinchou","Zebstrika","Minun"]
"Spearow"	["Vikavolt","Plusle","Xurkitree","Electabuzz","Luxray","Togedemaru","Chinchou","Ampharos","Luxio","Zeraora"]
"Fearow"	["Electivire","Electrike","Togedemaru","Galvantula","Raichu","Zebstrika","Heliolisk","Zapdos","Thundurus","Chinchou"]
"Zubat"	["Joltik","Eelektrik","Luxray","Stunfisk","Zebstrika","Pincurchin","Heliolisk","Tynamo","Charjabug","Jolteon"]
"Golbat"	["Zeraora","Magneton","Galvantula","Pincurchin","Eelektross","Shinx","Xurkitree","Stunfisk","Togedemaru","Raikou"]
"Psyduck"	["Electivire","Xurkitree","Plusle","Magneton","Blitzle","Mareep","Zekrom","Manectric","Dracozolt","Heliolisk"]
"Golduck"	["Yamper","Flaaffy","Voltorb","Zapdos","Shinx","Electrike","Manectric","Zebstrika","Plusle","Minun"]
"Poliwag"	["Shinx","Magnemite","Morpeko","Blitzle","Emolga","Mareep","Galvantula","Tapu Koko","Arctozolt","Rotom"]
"Poliwhirl"	["Chinchou","Zeraora","Pincurchin","Yamper","Stunfisk","Rotom","Morpeko","Blitzle","Xurkitree","Manectric"]
"Poliwrath"	["Luxray","Electabuzz","Arctozolt","Luxio","Magnemite","Pikachu","Plusle","Emolga","Manectric","Zapdos"]
"Tentacool"	["Electrike","Tynamo","Ampharos","Arctozolt","Luxray","Zekrom","Tapu Koko","Rotom","Eelektross","Shinx"]
"Tentacruel"	["Galvantula","Pachirisu","Vikavolt","Jolteon","Elekid","Yamper","Charjabug","Electabuzz","Lanturn","Emolga"]
"Slowpoke"	["Galvantula","Helioptile","Yamper","Jolteon","Magnemite","Emolga","Pichu","Raichu","Regieleki","Charjabug"]
"Slowbro"	["Zekrom","Toxtricity","Dedenne","Pichu","Eelektross","Regieleki","Lanturn","Voltorb","Pikachu","Galvantula"]
"Farfetch'd"	["Tapu Koko","Thundurus","Arctozolt","Emolga","Boltund","Mareep","Eelektrik","Electrike","Helioptile","Magnezone"]
"Doduo"	["Flaaffy","Galvantula","Dedenne","Emolga","Tynamo","Morpeko","Magneton","Vikavolt","Tapu Koko","Boltund"]
"Dodrio"	["Raikou","Electrike","Pichu","Dracozolt","Eelektross","Magneton","Arctozolt","Charjabug","Helioptile","Mareep"]
"Seel"	["Luxray","Joltik","Electrode","Zebstrika","Thundurus","Rotom","Eelektrik","Luxio","Yamper","Electivire"]
"Dewgong"	["Magneton","Magnemite","Helioptile","Magnezone","Voltorb","Dracozolt","Rotom","Luxio","Galvantula","Boltund"]
"Shellder"	["Electrike","Magnemite","Flaaffy","Luxio","Joltik","Blitzle","Luxray","Raichu","Pincurchin","Yamper"]
"Cloyster"	["Luxray","Voltorb","Manectric","Minun","Jolteon","Toxel","Electabuzz","Ampharos","Eelektross","Raichu"]
"Krabby"	["Mareep","Ampharos","Emolga","Electrike","Chinchou","Arctozolt","Dedenne","Luxray","Xurkitree","Morpeko"]
"Kingler"	["Emolga","Magnemite","Thundurus","Tynamo","Electabuzz","Lanturn","Tapu Koko","Heliolisk","Joltik","Xurkitree"]
"Horsea"	["Xurkitree","Arctozolt","Helioptile","Morpeko","Shinx","Magnemite","Eelektross","Toxtricity","Galvantula","Elekid"]
"Seadra"	["Emolga","Raichu","Ampharos","Togedemaru","Zapdos","Blitzle","Electrike","Electabuzz","Electivire","Regieleki"]
"Goldeen"	["Thundurus","Helioptile","Electrode","Ampharos","Zekrom","Dracozolt","Charjabug","Eelektrik","Luxray","Mareep"]
"Seaking"	["Chinchou","Manectric","Mareep","Stunfisk","Electivire","Zeraora","Ampharos","Morpeko","Electrike","Eelektrik"]
"Staryu"	["Luxray","Joltik","Magneton","Rotom","Tynamo","Heliolisk","Dracozolt","Flaaffy","Jolteon","Raikou"]
"Starmie"	["Eelektross","Pincurchin","Flaaffy","Electivire","Thundurus","Minun","Eelektrik","Arctozolt","Magnemite","Raichu"]
"Magikarp"	["Stunfisk","Pachirisu","Flaaffy","Regieleki","Tynamo","Helioptile","Blitzle","Toxel","Zeraora","Rotom"]
"Gyarados"	["Magnezone","Zekrom","Tynamo","Chinchou","Lanturn","Thundurus","Raichu","Regieleki","Dracozolt","Vikavolt"]
"Lapras"	["Flaaffy","Eelektrik","Morpeko","Electivire","Dedenne","Thundurus","Magneton","Chinchou","Luxio","Charjabug"]
"Vaporeon"	["Helioptile","Heliolisk","Vikavolt","Rotom","Joltik","Stunfisk","Zeraora","Ampharos","Eelektross","Pichu"]
"Totodile"	["Eelektross","Arctozolt","Flaaffy","Yamper","Manectric","Electrode","Togedemaru","Magnemite","Blitzle","Morpeko"]
"Croconaw"	["Raichu","Tynamo","Magneton","Zebstrika","Luxio","Joltik","Plusle","Dracozolt","Toxel","Pikachu"]
"Feraligatr"	["Zeraora","Jolteon","Plusle","Minun","Eelektrik","Pachirisu","Electrode","Voltorb","Heliolisk","Magnezone"]
"Hoothoot"	["Dedenne","Pichu","Jolteon","Manectric","Galvantula","Boltund","Yamper","Chinchou","Pincurchin","Flaaffy"]
"Noctowl"	["Minun","Raikou","Eelektross","Toxtricity","Lanturn","Charjabug","Thundurus","Pichu","Jolteon","Zapdos"]
"Crobat"	["Toxtricity","Plusle","Luxio","Joltik","Zekrom","Zeraora","Stunfisk","Rotom","Blitzle","Electrike"]
"Togetic"	["Joltik","Vikavolt","Magnemite","Ampharos","Shinx","Pikachu","Lanturn","Toxel","Electivire","Voltorb"]
"Natu"	["Vikavolt","Toxel","Jolteon","Eelektrik","Magneton","Flaaffy","Pincurchin","Electabuzz","Voltorb","Tynamo"]
"Xatu"	["Heliolisk","Yamper","Elekid","Minun","Eelektrik","Toxel","Galvantula","Raikou","Magnezone","Pikachu"]
"Marill"	["Stunfisk","Magneton","Togedemaru","Zeraora","Toxtricity","Luxio","Mareep","Magnemite","Pincurchin","Helioptile"]
"Azumarill"	["Plusle","Vikavolt","Pikachu","Manectric","Jolteon","Blitzle","Shinx","Tynamo","Zebstrika","Luxray"]
"Politoed"	["Electrike","Electabuzz","Thundurus","Tapu Koko","Electrode","Joltik","Raichu","Rotom","Stunfisk","Arctozolt"]
"Murkrow"	["Flaaffy","Joltik","Stunfisk","Pachirisu","Voltorb","Mareep","Zeraora","Arctozolt","Morpeko","Plusle"]
"Slowking"	["Charjabug","Toxel","Zekrom","Joltik","Mareep","Voltorb","Manectric","Zapdos","Minun","Lanturn"]
"Qwilfish"	["Regieleki","Pikachu","Boltund","Eelektrik","Luxray","Magnemite","Togedemaru","Blitzle","Electivire","Pincurchin"]
"Remoraid"	["Pachirisu","Joltik","Togedemaru","Plusle","Magnezone","Arctozolt","Toxtricity","Vikavolt","Tynamo","Voltorb"]
"Octillery"	["Pikachu","Toxtricity","Helioptile","Boltund","Vikavolt","Joltik","Plusle","Zeraora","Zapdos","Eelektross"]
"Mantine"	["Morpeko","Rotom","Vikavolt","Pachirisu","Shinx","Zeraora","Magnemite","Luxray","Pikachu","Flaaffy"]
"Suicune"	["Rotom","Emolga","Galvantula","Dedenne","Tapu Koko","Heliolisk","Electivire","Zebstrika","Tynamo","Ampharos"]
"Lugia"	["Magnemite","Eelektrik","Magnezone","Elekid","Magneton","Electivire","Tynamo","Regieleki","Luxio","Galvantula"]
"Mudkip"	["Helioptile","Minun","Arctozolt","Luxio","Raichu","Heliolisk","Ampharos","Lanturn","Blitzle","Magnezone"]
"Taillow"	["Mareep","Arctozolt","Ampharos","Zebstrika","Electrike","Pachirisu","Jolteon","Magnezone","Togedemaru","Thundurus"]
"Swellow"	["Raikou","Yamper","Heliolisk","Luxio","Arctozolt","Raichu","Togedemaru","Galvantula","Pichu","Dedenne"]
"Wingull"	["Electrode","Electrike","Pachirisu","Manectric","Pikachu","Emolga","Arctozolt","Charjabug","Tapu Koko","Electivire"]
"Pelipper"	["Jolteon","Emolga","Luxio","Chinchou","Xurkitree","Yamper","Rotom","Charjabug","Blitzle","Thundurus"]
"Surskit"	["Lanturn","Luxio","Arctozolt","Chinchou","Tynamo","Eelektross","Flaaffy","Electrode","Toxtricity","Pachirisu"]
"Carvanha"	["Manectric","Joltik","Arctozolt","Zapdos","Charjabug","Raikou","Dedenne","Zeraora","Minun","Toxtricity"]
"Sharpedo"	["Galvantula","Chinchou","Dedenne","Magnemite","Electrode","Rotom","Electrike","Eelektross","Thundurus","Pincurchin"]
"Wailmer"	["Dedenne","Magneton","Arctozolt","Eelektrik","Toxtricity","Tynamo","Yamper","Minun","Raikou","Shinx"]
"Wailord"	["Rotom","Zapdos","Luxio","Blitzle","Galvantula","Raikou","Mareep","Voltorb","Flaaffy","Ampharos"]
"Swablu"	["Manectric","Tynamo","Zebstrika","Stunfisk","Magnezone","Charjabug","Emolga","Pincurchin","Magnemite","Electivire"]
"Corphish"	["Elekid","Helioptile","Magnemite","Chinchou","Shinx","Arctozolt","Xurkitree","Luxio","Morpeko","Plusle"]
"Crawdaunt"	["Joltik","Tapu Koko","Regieleki","Eelektross","Rotom","Dedenne","Emolga","Pincurchin","Luxio","Magnemite"]
"Spheal"	["Arctozolt","Thundurus","Electivire","Zeraora","Eelektross","Toxtricity","Mareep","Zebstrika","Magnezone","Shinx"]
"Sealeo"	["Magnemite","Dedenne","Plusle","Zeraora","Shinx","Ampharos","Magneton","Tynamo","Dracozolt","Toxel"]
"Walrein"	["Electabuzz","Toxel","Ampharos","Eelektross","Pachirisu","Xurkitree","Zebstrika","Plusle","Voltorb","Zeraora"]
"Clamperl"	["Yamper","Chinchou","Flaaffy","Magnemite","Zapdos","Voltorb","Lanturn","Dracozolt","Charjabug","Toxtricity"]
"Huntail"	["Electabuzz","Electrode","Luxray","Shinx","Raichu","Helioptile","Chinchou","Zeraora","Zekrom","Joltik"]
"Gorebyss"	["Electrode","Manectric","Togedemaru","Vikavolt","Pichu","Electivire","Heliolisk","Blitzle","Magneton","Jolteon"]
"Luvdisc"	["Tynamo","Minun","Mareep","Jolteon","Electrode","Magneton","Eelektrik","Toxtricity","Dracozolt","Galvantula"]
"Kyogre"	["Magnemite","Eelektrik","Flaaffy","Magneton","Ampharos","Zekrom","Dedenne","Pincurchin","Eelektross","Heliolisk"]
"Piplup"	["Shinx","Toxtricity","Rotom","Manectric","Blitzle","Electrike","Helioptile","Eelektross","Zeraora","Eelektrik"]
"Prinplup"	["Togedemaru","Luxio","Boltund","Raikou","Electrode","Vikavolt","Toxtricity","Magneton","Plusle","Luxray"]
"Empoleon"	["Luxray","Arctozolt","Regieleki","Heliolisk","Flaaffy","Blitzle","Luxio","Morpeko","Eelektross","Boltund"]
"Starly"	["Arctozolt","Shinx","Heliolisk","Raikou","Plusle","Emolga","Luxio","Charjabug","Zeraora","Flaaffy"]
"Staravia"	["Galvantula","Vikavolt","Minun","Pikachu","Electivire","Plusle","Mareep","Eelektross","Morpeko","Eelektrik"]
"Staraptor"	["Pincurchin","Rotom","Vikavolt","Electrode","Arctozolt","Zeraora","Mareep","Electivire","Regieleki","Dedenne"]
"Bibarel"	["Pichu","Yamper","Magneton","Thundurus","Togedemaru","Pachirisu","Raichu","Heliolisk","Magnezone","Ampharos"]
"Buizel"	["Minun","Jolteon","Vikavolt","Pikachu","Yamper","Manectric","Eelektrik","Charjabug","Lanturn","Magneton"]
"Floatzel"	["Vikavolt","Helioptile","Zeraora","Togedemaru","Jolteon","Shinx","Blitzle","Toxtricity","Toxel","Eelektross"]
"Shellos"	["Pachirisu","Emolga","Dedenne","Boltund","Zeraora","Voltorb","Heliolisk","Tapu Koko","Arctozolt","Stunfisk"]
"Drifloon"	["Zeraora","Flaaffy","Helioptile","Charjabug","Chinchou","Arctozolt","Ampharos","Luxray","Yamper","Dracozolt"]
"Drifblim"	["Elekid","Magneton","Pincurchin","Chinchou","Yamper","Stunfisk","Mareep","Magnezone","Dracozolt","Dedenne"]
"Honchkrow"	["Electabuzz","Pincurchin","Minun","Rotom","Ampharos","Emolga","Eelektrik","Raichu","Galvantula","Tynamo"]
"Chatot"	["Rotom","Manectric","Morpeko","Galvantula","Electivire","Charjabug","Pincurchin","Electrike","Thundurus","Boltund"]
"Finneon"	["Luxio","Magnemite","Shinx","Luxray","Plusle","Tapu Koko","Zekrom","Pachirisu","Galvantula","Helioptile"]
"Lumineon"	["Toxtricity","Shinx","Electrode","Electrike","Rotom","Vikavolt","Pichu","Morpeko","Magneton","Yamper"]
"Mantyke"	["Raichu","Manectric","Pikachu","Chinchou","Morpeko","Dracozolt","Toxel","Magnemite","Thundurus","Flaaffy"]
"Togekiss"	["Voltorb","Pichu","Electrike","Zeraora","Morpeko","Minun","Magnezone","Electabuzz","Galvantula","Pincurchin"]
"Phione"	["Joltik","Pachirisu","Magneton","Voltorb","Zeraora","Eelektrik","Pincurchin","Blitzle","Thundurus","Tapu Koko"]
"Manaphy"	["Arctozolt","Thundurus","Luxio","Charjabug","Elekid","Zekrom","Chinchou","Eelektrik","Ampharos","Magnemite"]
"Oshawott"	["Elekid","Raikou","Heliolisk","Regieleki","Pichu","Charjabug","Blitzle","Dedenne","Magnezone","Chinchou"]
"Dewott"	["Luxray","Magneton","Raikou","Dracozolt","Toxtricity","Lanturn","Xurkitree","Dedenne","Yamper","Tynamo"]
"Samurott"	["Toxtricity","Helioptile","Zapdos","Dedenne","Shinx","Heliolisk","Magneton","Flaaffy","Voltorb","Emolga"]
"Panpour"	["Electivire","Raichu","Magneton","Magnemite","Electrode","Jolteon","Minun","Rotom","Morpeko","Luxray"]
"Simipour"	["Magneton","Galvantula","Zeraora","Voltorb","Arctozolt","Helioptile","Yamper","Flaaffy","Blitzle","Joltik"]
"Pidove"	["Rotom","Magneton","Jolteon","Galvantula","Plusle","Magnemite","Zapdos","Voltorb","Tapu Koko","Ampharos"]
"Tranquill"	["Galvantula","Tapu Koko","Helioptile","Electrode","Flaaffy","Manectric","Minun","Blitzle","Dracozolt","Joltik"]
"Unfezant"	["Joltik","Minun","Tynamo","Chinchou","Luxray","Flaaffy","Galvantula","Elekid","Electrike","Eelektrik"]
"Woobat"	["Minun","Zebstrika","Eelektrik","Stunfisk","Mareep","Boltund","Rotom","Chinchou","Xurkitree","Zeraora"]
"Swoobat"	["Flaaffy","Thundurus","Mareep","Electrike","Pachirisu","Eelektross","Electabuzz","Helioptile","Luxio","Regieleki"]
"Tympole"	["Zapdos","Pikachu","Zeraora","Regieleki","Pichu","Zebstrika","Elekid","Xurkitree","Arctozolt","Emolga"]
"Basculin"	["Zebstrika","Yamper","Pachirisu","Luxio","Heliolisk","Voltorb","Elekid","Regieleki","Arctozolt","Shinx"]
"Sigilyph"	["Raichu","Vikavolt","Electrode","Luxio","Zeraora","Jolteon","Emolga","Heliolisk","Tapu Koko","Helioptile"]
"Ducklett"	["Chinchou","Pachirisu","Vikavolt","Electrike","Toxtricity","Joltik","Helioptile","Magnezone","Emolga","Tapu Koko"]
"Swanna"	["Pincurchin","Tapu Koko","Togedemaru","Pachirisu","Magneton","Flaaffy","Zekrom","Xurkitree","Regieleki","Rotom"]
"Frillish"	["Pichu","Zebstrika","Pincurchin","Toxel","Boltund","Minun","Mareep","Jolteon","Pachirisu","Tapu Koko"]
"Jellicent"	["Vikavolt","Zekrom","Plusle","Rotom","Electrode","Magnemite","Stunfisk","Togedemaru","Lanturn","Pachirisu"]
"Alomomola"	["Luxray","Zapdos","Xurkitree","Manectric","Stunfisk","Togedemaru","Pachirisu","Blitzle","Eelektrik","Plusle"]
"Rufflet"	["Zeraora","Pachirisu","Luxray","Electabuzz","Heliolisk","Zekrom","Yamper","Toxel","Luxio","Dracozolt"]
"Braviary"	["Lanturn","Jolteon","Elekid","Morpeko","Blitzle","Galvantula","Dedenne","Tapu Koko","Yamper","Chinchou"]
"Vullaby"	["Toxtricity","Elekid","Raichu","Electrike","Raikou","Luxio","Zapdos","Luxray","Tapu Koko","Dedenne"]
"Mandibuzz"	["Zekrom","Magneton","Boltund","Flaaffy","Pincurchin","Eelektrik","Manectric","Helioptile","Pikachu","Blitzle"]
"Tornadus"	["Togedemaru","Luxray","Elekid","Regieleki","Chinchou","Raikou","Yamper","Plusle","Luxio","Magnemite"]
"Keldeo"	["Magneton","Zekrom","Dedenne","Ampharos","Mareep","Electabuzz","Regieleki","Tynamo","Stunfisk","Electrike"]
"Froakie"	["Toxel","Pichu","Xurkitree","Voltorb","Toxtricity","Eelektrik","Electabuzz","Minun","Shinx","Zeraora"]
"Frogadier"	["Eelektrik","Toxel","Heliolisk","Magnezone","Joltik","Flaaffy","Dedenne","Zeraora","Electabuzz","Ampharos"]
"Greninja"	["Elekid","Thundurus","Eelektrik","Yamper","Electrike","Electabuzz","Zeraora","Toxtricity","Regieleki","Pichu"]
"Fletchling"	["Dracozolt","Charjabug","Morpeko","Luxray","Arctozolt","Lanturn","Luxio","Jolteon","Thundurus","Regieleki"]
"Skrelp"	["Pincurchin","Electrode","Electabuzz","Voltorb","Dracozolt","Yamper","Jolteon","Emolga","Electrike","Ampharos"]
"Clauncher"	["Shinx","Xurkitree","Ampharos","Togedemaru","Luxio","Morpeko","Dedenne","Zeraora","Elekid","Flaaffy"]
"Clawitzer"	["Voltorb","Electrike","Plusle","Dedenne","Joltik","Minun","Flaaffy","Galvantula","Yamper","Xurkitree"]
"Hawlucha"	["Zekrom","Magnemite","Zeraora","Electabuzz","Voltorb","Zebstrika","Emolga","Stunfisk","Luxio","Pincurchin"]
"Yveltal"	["Zebstrika","Tapu Koko","Rotom","Zapdos","Eelektross","Pincurchin","Electabuzz","Blitzle","Electivire","Emolga"]
"Volcanion"	["Tynamo","Manectric","Zapdos","Luxio","Luxray","Zekrom","Lanturn","Vikavolt","Magnemite","Morpeko"]
"Popplio"	["Stunfisk","Zeraora","Electrode","Pincurchin","Joltik","Magneton","Thundurus","Dedenne","Eelektrik","Dracozolt"]
"Brionne"	["Zekrom","Pachirisu","Lanturn","Electabuzz","Zapdos","Raikou","Charjabug","Raichu","Xurkitree","Vikavolt"]
"Primarina"	["Galvantula","Pachirisu","Raikou","Minun","Thundurus","Chinchou","Arctozolt","Magnemite","Dracozolt","Shinx"]
"Pikipek"	["Togedemaru","Minun","Magnemite","Emolga","Flaaffy","Joltik","Voltorb","Tynamo","Electivire","Blitzle"]
"Trumbeak"	["Electrode","Raichu","Stunfisk","Magneton","Morpeko","Magnemite","Tapu Koko","Zapdos","Pichu","Boltund"]
"Toucannon"	["Blitzle","Electabuzz","Thundurus","Electrike","Dracozolt","Mareep","Pikachu","Magneton","Stunfisk","Morpeko"]
"Wishiwashi"	["Electrode","Magnezone","Magnemite","Morpeko","Eelektross","Pachirisu","Plusle","Rotom","Shinx","Raichu"]
"Mareanie"	["Helioptile","Togedemaru","Heliolisk","Regieleki","Boltund","Manectric","Eelektrik","Magnezone","Chinchou","Mareep"]
"Toxapex"	["Magneton","Zekrom","Chinchou","Pincurchin","Blitzle","Zeraora","Arctozolt","Emolga","Plusle","Morpeko"]
"Dewpider"	["Xurkitree","Dedenne","Electivire","Tynamo","Magneton","Morpeko","Pikachu","Boltund","Toxel","Raichu"]
"Araquanid"	["Shinx","Thundurus","Zebstrika","Pichu","Magnemite","Raikou","Electivire","Magnezone","Luxio","Charjabug"]
"Wimpod"	["Yamper","Togedemaru","Thundurus","Stunfisk","Magnemite","Luxray","Plusle","Heliolisk","Blitzle","Eelektross"]
"Golisopod"	["Pachirisu","Zeraora","Electabuzz","Plusle","Raichu","Minun","Blitzle","Magnemite","Magnezone","Voltorb"]
"Pyukumuku"	["Tapu Koko","Blitzle","Minun","Toxtricity","Toxel","Galvantula","Boltund","Manectric","Joltik","Pikachu"]
"Bruxish"	["Minun","Plusle","Lanturn","Shinx","Togedemaru","Manectric","Eelektross","Heliolisk","Zeraora","Electabuzz"]
"Tapu Fini"	["Raikou","Charjabug","Emolga","Rotom","Zapdos","Helioptile","Regieleki","Arctozolt","Thundurus","Dedenne"]
"Sobble"	["Eelektross","Toxtricity","Zeraora","Blitzle","Plusle","Charjabug","Zekrom","Shinx","Heliolisk","Electivire"]
"Drizzile"	["Rotom","Electivire","Tapu Koko","Electabuzz","Dracozolt","Pachirisu","Electrike","Pincurchin","Electrode","Eelektross"]
"Inteleon"	["Xurkitree","Electivire","Helioptile","Charjabug","Raikou","Regieleki","Flaaffy","Boltund","Joltik","Magneton"]
"Rookidee"	["Regieleki","Zekrom","Luxio","Charjabug","Blitzle","Zeraora","Stunfisk","Tynamo","Joltik","Heliolisk"]
"Corvisquire"	["Helioptile","Chinchou","Raichu","Regieleki","Lanturn","Dracozolt","Morpeko","Pikachu","Magnemite","Yamper"]
"Chewtle"	["Vikavolt","Xurkitree","Shinx","Voltorb","Electabuzz","Togedemaru","Manectric","Pichu","Pincurchin","Magnemite"]
"Cramorant"	["Zebstrika","Pachirisu","Manectric","Electabuzz","Xurkitree","Thundurus","Eelektross","Flaaffy","Helioptile","Stunfisk"]
"Arrokuda"	["Stunfisk","Arctozolt","Electrike","Lanturn","Ampharos","Thundurus","Zebstrika","Electabuzz","Eelektrik","Helioptile"]
"Barraskewda"	["Mareep","Morpeko","Galvantula","Togedemaru","Toxtricity","Raichu","Electrode","Ampharos","Electrike","Lanturn"]
"Arctovish"	["Mareep","Raikou","Eelektrik","Heliolisk","Raichu","Galvantula","Emolga","Regieleki","Pichu","Boltund"]
"Sableye"	["Comfey","Florges","Clefable","Diancie","Azumarill","Ribombee","Tapu Bulu","Cutiefly","Swirlix","Togetic"]
"Spiritomb"	["Shiinotic","Flabebe","Slurpuff","Marill","Tapu Lele","Mimikyu","Igglybuff","Cutiefly","Spritzee","Grimmsnarl"]
"Scraggy"	["Hatterene","Whimsicott","Tapu Koko","Granbull","Morgrem","Spritzee","Clefable","Mime Jr.","Tapu Bulu","Azurill"]
"Scrafty"	["Primarina","Alcremie","Kirlia","Ribombee","Dedenne","Togekiss","Flabebe","Milcery","Grimmsnarl","Xerneas"]
"Deino"	["Tapu Lele","Gardevoir","Cleffa","Cottonee","Alcremie","Klefki","Clefable","Mawile","Slurpuff","Shiinotic"]
"Zweilous"	["Togekiss","Sylveon","Togetic","Azurill","Xerneas","Marill","Carbink","Tapu Lele","Cottonee","Aromatisse"]
"Hydreigon"	["Togekiss","Florges","Impidimp","Floette","Grimmsnarl","Tapu Bulu","Tapu Lele","Snubbull","Tapu Fini","Carbink"]
"Pangoro"	["Mimikyu","Dedenne","Slurpuff","Impidimp","Aromatisse","Grimmsnarl","Xerneas","Marill","Tapu Bulu","Tapu Koko"]
"Hakamo-o"	["Morelull","Magearna","Shiinotic","Klefki","Spritzee","Dedenne","Ribombee","Whimsicott","Igglybuff","Jigglypuff"]
"Kommo-o"	["Mime Jr.","Tapu Lele","Morgrem","Carbink","Jigglypuff","Cleffa","Clefable","Klefki","Snubbull","Togepi"]
"Guzzlord"	["Togekiss","Spritzee","Floette","Jigglypuff","Tapu Koko","Clefable","Aromatisse","Dedenne","Togepi","Diancie"]
"Urshifu"	["Togetic","Hatterene","Whimsicott","Zacian","Cottonee","Aromatisse","Impidimp","Cleffa","Klefki","Togekiss"]
"Rattata"	["Scraggy","Riolu","Keldeo","Sawk","Chesnaught","Mienfoo","Pignite","Tyrogue","Kubfu","Machamp"]
"Raticate"	["Grapploct","Marshadow","Keldeo","Scrafty","Breloom","Clobbopus","Hitmonchan","Poliwrath","Makuhita","Virizion"]
"Meowth"	["Hariyama","Medicham","Gurdurr","Hakamo-o","Timburr","Keldeo","Mankey","Infernape","Hitmonlee","Heracross"]
"Persian"	["Mienshao","Passimian","Machop","Croagunk","Marshadow","Machoke","Heracross","Zamazenta","Machamp","Clobbopus"]
"Lickitung"	["Gurdurr","Breloom","Terrakion","Crabrawler","Stufful","Pancham","Sawk","Emboar","Crabominable","Throh"]
"Kangaskhan"	["Machop","Combusken","Riolu","Pignite","Hitmontop","Terrakion","Emboar","Keldeo","Medicham","Poliwrath"]
"Tauros"	["Pangoro","Poliwrath","Lucario","Mienshao","Scraggy","Urshifu","Buzzwole","Gallade","Sawk","Machoke"]
"Ditto"	["Hitmonlee","Pignite","Hawlucha","Marshadow","Blaziken","Stufful","Sawk","Primeape","Breloom","Cobalion"]
"Eevee"	["Kommo-o","Combusken","Poliwrath","Chesnaught","Bewear","Kubfu","Buzzwole","Mienfoo","Sirfetch'd","Pangoro"]
"Porygon"	["Grapploct","Hawlucha","Zamazenta","Virizion","Medicham","Pignite","Croagunk","Lucario","Gurdurr","Marshadow"]
"Snorlax"	["Conkeldurr","Terrakion","Sirfetch'd","Toxicroak","Pancham","Scraggy","Marshadow","Passimian","Keldeo","Sawk"]
"Sentret"	["Zamazenta","Conkeldurr","Chesnaught","Grapploct","Blaziken","Crabominable","Keldeo","Gurdurr","Primeape","Crabrawler"]
"Furret"	["Medicham","Scrafty","Poliwrath","Machop","Keldeo","Hakamo-o","Pangoro","Urshifu","Riolu","Terrakion"]
"Aipom"	["Meditite","Timburr","Scraggy","Pignite","Virizion","Buzzwole","Hawlucha","Lucario","Conkeldurr","Crabrawler"]
"Umbreon"	["Toxicroak","Hawlucha","Poliwrath","Falinks","Hitmonchan","Cobalion","Hitmontop","Breloom","Primeape","Buzzwole"]
"Dunsparce"	["Monferno","Marshadow","Emboar","Machoke","Gurdurr","Conkeldurr","Zamazenta","Tyrogue","Falinks","Primeape"]
"Sneasel"	["Machamp","Machoke","Hariyama","Virizion","Kommo-o","Conkeldurr","Clobbopus","Croagunk","Kubfu","Medicham"]
"Teddiursa"	["Hawlucha","Monferno","Chesnaught","Pheromosa","Crabrawler","Machoke","Hariyama","Hitmonchan","Scraggy","Stufful"]
"Ursaring"	["Buzzwole","Hawlucha","Pancham","Monferno","Hitmonlee","Primeape","Keldeo","Hitmontop","Pangoro","Crabominable"]
"Porygon2"	["Passimian","Scraggy","Stufful","Mienshao","Buzzwole","Infernape","Heracross","Riolu","Mienfoo","Breloom"]
"Stantler"	["Terrakion","Chesnaught","Hariyama","Clobbopus","Keldeo","Urshifu","Mienfoo","Bewear","Infernape","Falinks"]
"Smeargle"	["Pheromosa","Tyrogue","Heracross","Kubfu","Chesnaught","Scrafty","Pancham","Hawlucha","Hitmonchan","Toxicroak"]
"Miltank"	["Chesnaught","Falinks","Monferno","Passimian","Pignite","Sirfetch'd","Primeape","Cobalion","Sawk","Stufful"]
"Blissey"	["Marshadow","Mankey","Keldeo","Buzzwole","Kubfu","Kommo-o","Bewear","Croagunk","Machop","Conkeldurr"]
"Tyranitar"	["Hitmonlee","Monferno","Croagunk","Heracross","Clobbopus","Machoke","Terrakion","Hakamo-o","Pancham","Cobalion"]
"Poochyena"	["Zamazenta","Urshifu","Conkeldurr","Pancham","Marshadow","Clobbopus","Mankey","Sawk","Toxicroak","Keldeo"]
"Mightyena"	["Grapploct","Hakamo-o","Pignite","Sawk","Keldeo","Pancham","Crabrawler","Hariyama","Hitmonchan","Hawlucha"]
"Zigzagoon"	["Bewear","Kommo-o","Mankey","Hitmontop","Makuhita","Pangoro","Blaziken","Grapploct","Sawk","Hitmonlee"]
"Linoone"	["Throh","Tyrogue","Machamp","Crabrawler","Urshifu","Primeape","Heracross","Passimian","Riolu","Pheromosa"]
"Slakoth"	["Blaziken","Hariyama","Riolu","Stufful","Pignite","Kubfu","Mienfoo","Poliwrath","Monferno","Clobbopus"]
"Vigoroth"	["Makuhita","Riolu","Toxicroak","Gallade","Stufful","Primeape","Pheromosa","Hariyama","Hitmonlee","Hawlucha"]
"Slaking"	["Lucario","Toxicroak","Gallade","Poliwrath","Timburr","Hariyama","Pignite","Mankey","Meditite","Stufful"]
"Whismur"	["Tyrogue","Crabrawler","Heracross","Machamp","Hawlucha","Virizion","Hitmonchan","Hitmontop","Kommo-o","Terrakion"]
"Loudred"	["Machamp","Crabrawler","Grapploct","Conkeldurr","Hitmonchan","Stufful","Cobalion","Kommo-o","Crabominable","Toxicroak"]
"Exploud"	["Kommo-o","Riolu","Hitmontop","Hakamo-o","Kubfu","Mankey","Meditite","Machoke","Pancham","Pignite"]
"Skitty"	["Grapploct","Poliwrath","Crabrawler","Hakamo-o","Virizion","Mankey","Monferno","Tyrogue","Terrakion","Hawlucha"]
"Delcatty"	["Marshadow","Conkeldurr","Sirfetch'd","Pheromosa","Hitmonchan","Clobbopus","Combusken","Hariyama","Machop","Lucario"]
"Aron"	["Chesnaught","Hitmontop","Bewear","Timburr","Urshifu","Scraggy","Machamp","Clobbopus","Marshadow","Pheromosa"]
"Lairon"	["Lucario","Poliwrath","Pancham","Chesnaught","Crabominable","Mienshao","Terrakion","Riolu","Gallade","Hawlucha"]
"Aggron"	["Crabominable","Makuhita","Toxicroak","Falinks","Virizion","Scraggy","Heracross","Sirfetch'd","Blaziken","Crabrawler"]
"Spinda"	["Poliwrath","Primeape","Breloom","Kubfu","Falinks","Machamp","Cobalion","Passimian","Mienfoo","Hitmonchan"]
"Zangoose"	["Machoke","Zamazenta","Primeape","Conkeldurr","Hitmonchan","Kubfu","Pheromosa","Gurdurr","Kommo-o","Sirfetch'd"]
"Castform"	["Blaziken","Stufful","Bewear","Throh","Hakamo-o","Clobbopus","Hariyama","Monferno","Toxicroak","Machop"]
"Kecleon"	["Tyrogue","Hitmontop","Scraggy","Infernape","Hitmonchan","Lucario","Blaziken","Machamp","Monferno","Marshadow"]
"Absol"	["Emboar","Zamazenta","Machamp","Hitmonchan","Meditite","Clobbopus","Crabrawler","Blaziken","Hitmonlee","Infernape"]
"Bidoof"	["Mankey","Terrakion","Kubfu","Falinks","Breloom","Pheromosa","Cobalion","Grapploct","Scrafty","Kommo-o"]
"Shieldon"	["Keldeo","Machamp","Falinks","Kommo-o","Marshadow","Crabrawler","Machoke","Medicham","Heracross","Hitmonlee"]
"Bastiodon"	["Breloom","Terrakion","Gallade","Throh","Urshifu","Primeape","Emboar","Pheromosa","Clobbopus","Pignite"]
"Ambipom"	["Sawk","Pignite","Combusken","Medicham","Riolu","Primeape","Mankey","Conkeldurr","Timburr","Buzzwole"]
"Buneary"	["Scrafty","Blaziken","Cobalion","Pancham","Breloom","Mienshao","Sawk","Pheromosa","Monferno","Heracross"]
"Lopunny"	["Croagunk","Clobbopus","Combusken","Buzzwole","Pangoro","Pancham","Toxicroak","Machop","Gallade","Heracross"]
"Glameow"	["Scraggy","Sawk","Combusken","Conkeldurr","Mienshao","Hariyama","Toxicroak","Hakamo-o","Machamp","Grapploct"]
"Purugly"	["Kommo-o","Pheromosa","Crabrawler","Lucario","Terrakion","Timburr","Pangoro","Mankey","Combusken","Scraggy"]
"Happiny"	["Scraggy","Kommo-o","Clobbopus","Timburr","Bewear","Hitmonlee","Toxicroak","Emboar","Makuhita","Pancham"]
"Munchlax"	["Sawk","Timburr","Emboar","Croagunk","Scrafty","Combusken","Tyrogue","Cobalion","Keldeo","Makuhita"]
"Weavile"	["Sirfetch'd","Infernape","Hitmonlee","Combusken","Hitmontop","Mienfoo","Croagunk","Hawlucha","Chesnaught","Medicham"]
"Lickilicky"	["Heracross","Combusken","Zamazenta","Scrafty","Crabominable","Pangoro","Hawlucha","Hakamo-o","Pancham","Hitmonlee"]
"Porygon-Z"	["Zamazenta","Timburr","Mankey","Hitmonchan","Marshadow","Gallade","Infernape","Combusken","Cobalion","Crabrawler"]
"Probopass"	["Monferno","Cobalion","Emboar","Toxicroak","Crabrawler","Medicham","Kommo-o","Machamp","Urshifu","Kubfu"]
"Dialga"	["Marshadow","Machoke","Pignite","Primeape","Hakamo-o","Gallade","Machamp","Mienshao","Pangoro","Scrafty"]
"Regigigas"	["Stufful","Infernape","Machamp","Gallade","Hitmontop","Gurdurr","Machoke","Mankey","Throh","Zamazenta"]
"Darkrai"	["Pheromosa","Hakamo-o","Mienshao","Monferno","Hitmonlee","Primeape","Croagunk","Bewear","Gurdurr","Lucario"]
"Arceus"	["Croagunk","Hawlucha","Crabominable","Poliwrath","Chesnaught","Hitmontop","Machop","Hakamo-o","Stufful","Tyrogue"]
"Patrat"	["Marshadow","Falinks","Buzzwole","Monferno","Sawk","Urshifu","Mienshao","Heracross","Combusken","Pangoro"]
"Watchog"	["Riolu","Hitmonlee","Kubfu","Marshadow","Pheromosa","Pignite","Machamp","Sirfetch'd","Meditite","Lucario"]
"Lillipup"	["Infernape","Croagunk","Hitmontop","Hariyama","Hitmonlee","Makuhita","Sirfetch'd","Lucario","Hitmonchan","Heracross"]
"Herdier"	["Crabrawler","Toxicroak","Medicham","Pancham","Kubfu","Tyrogue","Zamazenta","Sawk","Hitmontop","Lucario"]
"Stoutland"	["Keldeo","Mankey","Monferno","Lucario","Bewear","Scraggy","Croagunk","Crabominable","Meditite","Crabrawler"]
"Purrloin"	["Primeape","Bewear","Zamazenta","Urshifu","Tyrogue","Marshadow","Pancham","Infernape","Gurdurr","Buzzwole"]
"Liepard"	["Mankey","Scrafty","Sirfetch'd","Virizion","Monferno","Mienshao","Primeape","Sawk","Infernape","Stufful"]
"Audino"	["Kommo-o","Grapploct","Blaziken","Scrafty","Throh","Hitmonchan","Cobalion","Mankey","Riolu","Crabrawler"]
"Zorua"	["Gurdurr","Marshadow","Lucario","Croagunk","Terrakion","Kubfu","Chesnaught","Kommo-o","Keldeo","Falinks"]
"Zoroark"	["Blaziken","Conkeldurr","Crabominable","Zamazenta","Primeape","Monferno","Terrakion","Virizion","Gallade","Sawk"]
"Minccino"	["Pangoro","Toxicroak","Gurdurr","Terrakion","Pancham","Makuhita","Hawlucha","Clobbopus","Stufful","Machop"]
"Cinccino"	["Meditite","Scraggy","Gallade","Bewear","Crabrawler","Machoke","Conkeldurr","Machop","Heracross","Combusken"]
"Pawniard"	["Machop","Toxicroak","Passimian","Timburr","Monferno","Terrakion","Pancham","Hitmontop","Gurdurr","Medicham"]
"Bisharp"	["Pheromosa","Machoke","Hitmonchan","Poliwrath","Meditite","Monferno","Crabrawler","Zamazenta","Pignite","Stufful"]
"Bouffalant"	["Falinks","Pancham","Pignite","Clobbopus","Poliwrath","Virizion","Medicham","Marshadow","Scraggy","Hitmonchan"]
"Kyurem"	["Kubfu","Croagunk","Primeape","Breloom","Grapploct","Keldeo","Hawlucha","Bewear","Hitmontop","Toxicroak"]
"Bunnelby"	["Poliwrath","Bewear","Keldeo","Mienfoo","Makuhita","Clobbopus","Croagunk","Mienshao","Timburr","Scraggy"]
"Furfrou"	["Kubfu","Scraggy","Keldeo","Throh","Grapploct","Breloom","Medicham","Stufful","Virizion","Urshifu"]
"Helioptile"	["Gurdurr","Monferno","Cobalion","Throh","Riolu","Hawlucha","Mienfoo","Pheromosa","Breloom","Hitmontop"]
"Heliolisk"	["Hitmontop","Toxicroak","Virizion","Hawlucha","Throh","Conkeldurr","Falinks","Keldeo","Machamp","Hitmonlee"]
"Amaura"	["Pignite","Falinks","Passimian","Tyrogue","Terrakion","Sawk","Scrafty","Croagunk","Lucario","Mankey"]
"Aurorus"	["Infernape","Mienfoo","Sawk","Machoke","Virizion","Scrafty","Breloom","Bewear","Zamazenta","Medicham"]
"Yungoos"	["Mienfoo","Hitmonlee","Pheromosa","Pignite","Infernape","Lucario","Breloom","Hakamo-o","Poliwrath","Terrakion"]
"Gumshoos"	["Scrafty","Mienfoo","Terrakion","Combusken","Blaziken","Crabominable","Buzzwole","Machop","Zamazenta","Hitmontop"]
"Stufful"	["Urshifu","Buzzwole","Machamp","Mienshao","Falinks","Lucario","Chesnaught","Scrafty","Pignite","Kommo-o"]
"Bewear"	["Machoke","Timburr","Croagunk","Hitmontop","Breloom","Marshadow","Machop","Scraggy","Clobbopus","Hitmonchan"]
"Silvally"	["Pignite","Toxicroak","Pangoro","Cobalion","Heracross","Tyrogue","Pheromosa","Virizion","Mienshao","Croagunk"]
"Komala"	["Poliwrath","Emboar","Passimian","Kubfu","Monferno","Makuhita","Kommo-o","Falinks","Pheromosa","Stufful"]
"Stakataka"	["Conkeldurr","Makuhita","Hakamo-o","Pancham","Pheromosa","Grapploct","Chesnaught","Marshadow","Pignite","Sawk"]
"Skwovet"	["Urshifu","Falinks","Combusken","Infernape","Gallade","Kommo-o","Passimian","Grapploct","Pancham","Mienfoo"]
"Greedent"	["Meditite","Machop","Stufful","Grapploct","Kommo-o","Terrakion","Mankey","Sirfetch'd","Toxicroak","Poliwrath"]
"Nickit"	["Hitmonlee","Crabrawler","Conkeldurr","Scrafty","Kubfu","Blaziken","Makuhita","Breloom","Scraggy","Machoke"]
"Thievul"	["Hariyama","Hitmonchan","Zamazenta","Poliwrath","Mienfoo","Urshifu","Hawlucha","Chesnaught","Falinks","Throh"]
"Wooloo"	["Mienfoo","Zamazenta","Machamp","Toxicroak","Tyrogue","Keldeo","Riolu","Heracross","Hawlucha","Stufful"]
"Dubwool"	["Grapploct","Pancham","Toxicroak","Kubfu","Croagunk","Meditite","Stufful","Pignite","Crabrawler","Medicham"]
"Obstagoon"	["Bewear","Pignite","Scraggy","Zamazenta","Kubfu","Urshifu","Pangoro","Marshadow","Timburr","Grapploct"]
"Morpeko"	["Breloom","Hitmonchan","Crabrawler","Kommo-o","Medicham","Machop","Bewear","Marshadow","Infernape","Stufful"]
"Duraludon"	["Breloom","Bewear","Primeape","Mienfoo","Urshifu","Grapploct","Clobbopus","Poliwrath","Marshadow","Gurdurr"]
"Bulbasaur"	["Fennekin","Turtonator","Tepig","Pyroar","Arcanine","Houndoom","Pansear","Numel","Rapidash","Reshiram"]
"Ivysaur"	["Torracat","Emboar","Scorbunny","Quilava","Lampent","Magmortar","Braixen","Infernape","Houndour","Blacephalon"]
"Venusaur"	["Moltres","Carkol","Ninetales","Tepig","Magmar","Pyroar","Scorbunny","Magcargo","Coalossal","Ponyta"]
"Caterpie"	["Lampent","Fennekin","Litwick","Ponyta","Pyroar","Carkol","Blacephalon","Pignite","Coalossal","Oricorio"]
"Metapod"	["Ho-Oh","Growlithe","Vulpix","Lampent","Ninetales","Cinderace","Litleo","Darmanitan","Houndoom","Camerupt"]
"Weedle"	["Slugma","Charmeleon","Larvesta","Cinderace","Fennekin","Cyndaquil","Chandelure","Houndour","Vulpix","Houndoom"]
"Kakuna"	["Vulpix","Blacephalon","Camerupt","Chimchar","Ponyta","Blaziken","Charmander","Magcargo","Ho-Oh","Fennekin"]
"Beedrill"	["Centiskorch","Turtonator","Larvesta","Typhlosion","Cinderace","Delphox","Slugma","Simisear","Chandelure","Infernape"]
"Oddish"	["Carkol","Incineroar","Charmeleon","Delphox","Combusken","Ninetales","Braixen","Coalossal","Moltres","Magmortar"]
"Gloom"	["Rapidash","Volcanion","Pyroar","Cinderace","Litwick","Charizard","Talonflame","Centiskorch","Tepig","Blaziken"]
"Vileplume"	["Litten","Fletchinder","Braixen","Charizard","Raboot","Charmander","Turtonator","Infernape","Larvesta","Typhlosion"]
"Paras"	["Pignite","Magby","Monferno","Slugma","Sizzlipede","Flareon","Fletchinder","Magcargo","Larvesta","Moltres"]
"Parasect"	["Torkoal","Volcarona","Charmeleon","Oricorio","Monferno","Braixen","Fennekin","Combusken","Pignite","Reshiram"]
"Venonat"	["Quilava","Scorbunny","Pyroar","Magmortar","Moltres","Blaziken","Heatran","Chandelure","Raboot","Charizard"]
"Venomoth"	["Torracat","Charizard","Cinderace","Salandit","Incineroar","Charmeleon","Carkol","Talonflame","Magmortar","Centiskorch"]
"Bellsprout"	["Simisear","Incineroar","Torracat","Houndour","Lampent","Numel","Pyroar","Torkoal","Ponyta","Ninetales"]
"Weepinbell"	["Centiskorch","Salandit","Ho-Oh","Combusken","Darmanitan","Ponyta","Chandelure","Typhlosion","Houndoom","Litwick"]
"Victreebel"	["Pansear","Incineroar","Litwick","Fennekin","Flareon","Typhlosion","Simisear","Pyroar","Blacephalon","Salandit"]
"Tangela"	["Ninetales","Charizard","Flareon","Growlithe","Volcarona","Cyndaquil","Pyroar","Quilava","Fletchinder","Houndour"]
"Jynx"	["Fletchinder","Reshiram","Braixen","Cinderace","Pansear","Fennekin","Flareon","Victini","Chimchar","Charizard"]
"Pinsir"	["Darumaka","Larvesta","Volcarona","Houndoom","Slugma","Blaziken","Pignite","Lampent","Raboot","Ninetales"]
"Chikorita"	["Magcargo","Braixen","Heatmor","Darumaka","Chandelure","Pignite","Victini","Scorbunny","Cinderace","Carkol"]
"Bayleef"	["Turtonator","Rapidash","Entei","Houndour","Litwick","Litleo","Darmanitan","Numel","Victini","Torchic"]
"Meganium"	["Litwick","Volcanion","Houndoom","Quilava","Reshiram","Arcanine","Volcarona","Darumaka","Cyndaquil","Magby"]
"Spinarak"	["Magby","Raboot","Houndour","Moltres","Entei","Slugma","Charizard","Delphox","Oricorio","Torchic"]
"Ariados"	["Charmeleon","Pyroar","Magby","Moltres","Charmander","Larvesta","Volcanion","Coalossal","Slugma","Charizard"]
"Bellossom"	["Blaziken","Centiskorch","Lampent","Heatran","Cyndaquil","Litleo","Chimchar","Raboot","Oricorio","Houndoom"]
"Sunkern"	["Monferno","Flareon","Incineroar","Fletchinder","Litleo","Coalossal","Heatmor","Victini","Raboot","Infernape"]
"Sunflora"	["Fletchinder","Raboot","Magcargo","Arcanine","Darumaka","Salazzle","Darmanitan","Charizard","Charmeleon","Ponyta"]
"Pineco"	["Quilava","Typhlosion","Entei","Braixen","Pignite","Darumaka","Litleo","Arcanine","Cyndaquil","Scorbunny"]
"Forretress"	["Centiskorch","Carkol","Incineroar","Charmeleon","Ho-Oh","Fennekin","Entei","Braixen","Blacephalon","Charmander"]
"Steelix"	["Carkol","Turtonator","Ponyta","Heatran","Flareon","Quilava","Fletchinder","Typhlosion","Darumaka","Torracat"]
"Scizor"	["Moltres","Rapidash","Oricorio","Lampent","Typhlosion","Magcargo","Flareon","Reshiram","Emboar","Heatran"]
"Swinub"	["Houndoom","Volcarona","Magby","Infernape","Magcargo","Chimchar","Numel","Raboot","Coalossal","Cyndaquil"]
"Piloswine"	["Sizzlipede","Incineroar","Camerupt","Flareon","Salandit","Growlithe","Volcanion","Talonflame","Emboar","Torchic"]
"Skarmory"	["Charmeleon","Camerupt","Ninetales","Monferno","Scorbunny","Numel","Tepig","Lampent","Volcanion","Larvesta"]
"Smoochum"	["Heatran","Reshiram","Houndour","Coalossal","Cyndaquil","Charmeleon","Cinderace","Magby","Pansear","Typhlosion"]
"Treecko"	["Delphox","Tepig","Torchic","Vulpix","Magmortar","Blaziken","Infernape","Heatran","Charmander","Darmanitan"]
"Grovyle"	["Volcanion","Quilava","Turtonator","Charmeleon","Blaziken","Flareon","Centiskorch","Infernape","Moltres","Heatmor"]
"Sceptile"	["Pansear","Typhlosion","Monferno","Turtonator","Emboar","Simisear","Torchic","Heatran","Quilava","Fletchinder"]
"Wurmple"	["Rapidash","Infernape","Pignite","Braixen","Flareon","Torracat","Blaziken","Entei","Chandelure","Numel"]
"Silcoon"	["Centiskorch","Fletchinder","Rapidash","Delphox","Torchic","Simisear","Darmanitan","Growlithe","Litleo","Blaziken"]
"Cascoon"	["Blaziken","Magby","Quilava","Charmeleon","Pansear","Vulpix","Darumaka","Houndoom","Litleo","Litten"]
"Dustox"	["Darumaka","Volcarona","Scorbunny","Victini","Rapidash","Chimchar","Heatran","Ninetales","Turtonator","Raboot"]
"Seedot"	["Quilava","Delphox","Sizzlipede","Carkol","Turtonator","Rapidash","Darumaka","Braixen","Litleo","Victini"]
"Shroomish"	["Charizard","Torchic","Pignite","Litleo","Typhlosion","Talonflame","Larvesta","Magby","Carkol","Pansear"]
"Nincada"	["Ponyta","Magmortar","Simisear","Coalossal","Centiskorch","Charizard","Larvesta","Emboar","Reshiram","Delphox"]
"Shedinja"	["Victini","Litwick","Infernape","Ho-Oh","Slugma","Raboot","Larvesta","Blaziken","Lampent","Reshiram"]
"Mawile"	["Ho-Oh","Charizard","Volcarona","Houndour","Magmortar","Charmeleon","Larvesta","Simisear","Arcanine","Heatmor"]
"Volbeat"	["Salazzle","Carkol","Blaziken","Pyroar","Growlithe","Fennekin","Monferno","Charmeleon","Darumaka","Pansear"]
"Illumise"	["Rapidash","Torchic","Raboot","Volcarona","Salazzle","Fennekin","Houndour","Pyroar","Litwick","Blacephalon"]
"Roselia"	["Ninetales","Cinderace","Raboot","Arcanine","Larvesta","Magby","Simisear","Magcargo","Chandelure","Delphox"]
"Cacnea"	["Simisear","Pansear","Ninetales","Chandelure","Scorbunny","Infernape","Arcanine","Charmander","Larvesta","Reshiram"]
"Snorunt"	["Torkoal","Heatran","Numel","Charizard","Victini","Braixen","Coalossal","Fennekin","Litwick","Pansear"]
"Glalie"	["Magcargo","Houndour","Volcarona","Torracat","Salandit","Tepig","Sizzlipede","Heatran","Litwick","Magby"]
"Beldum"	["Arcanine","Blacephalon","Magcargo","Salazzle","Charmander","Rapidash","Infernape","Braixen","Torchic","Emboar"]
"Metang"	["Monferno","Chimchar","Magmortar","Rapidash","Cyndaquil","Lampent","Vulpix","Delphox","Entei","Magmar"]
"Metagross"	["Carkol","Talonflame","Chandelure","Heatmor","Arcanine","Lampent","Camerupt","Torchic","Charmander","Heatran"]
"Regice"	["Charizard","Magby","Coalossal","Blaziken","Darumaka","Delphox","Charmander","Combusken","Larvesta","Reshiram"]
"Registeel"	["Fennekin","Reshiram","Arcanine","Carkol","Sizzlipede","Magby","Chimchar","Oricorio","Typhlosion","Litten"]
"Jirachi"	["Sizzlipede","Chimchar","Coalossal","Magmar","Talonflame","Raboot","Flareon","Turtonator","Arcanine","Camerupt"]
"Turtwig"	["Darumaka","Incineroar","Sizzlipede","Cinderace","Litten","Chandelure","Ho-Oh","Blaziken","Magmortar","Torchic"]
"Grotle"	["Salazzle","Torkoal","Growlithe","Pyroar","Chandelure","Houndoom","Typhlosion","Entei","Magmortar","Tepig"]
"Kricketot"	["Litten","Sizzlipede","Emboar","Torracat","Flareon","Carkol","Blaziken","Darmanitan","Lampent","Torkoal"]
"Kricketune"	["Incineroar","Charmeleon","Scorbunny","Oricorio","Carkol","Moltres","Coalossal","Magby","Raboot","Volcarona"]
"Budew"	["Sizzlipede","Cyndaquil","Arcanine","Oricorio","Tepig","Entei","Magmar","Torchic","Darmanitan","Scorbunny"]
"Roserade"	["Magmar","Moltres","Ponyta","Braixen","Coalossal","Fletchinder","Vulpix","Fennekin","Blaziken","Quilava"]
"Burmy"	["Charmander","Combusken","Heatran","Scorbunny","Torchic","Oricorio","Litten","Darumaka","Litleo","Arcanine"]
"Wormadam"	["Magcargo","Pyroar","Centiskorch","Torracat","Cinderace","Fennekin","Salazzle","Vulpix","Darmanitan","Ponyta"]
"Cherubi"	["Torracat","Salazzle","Chimchar","Reshiram","Turtonator","Tepig","Ho-Oh","Torchic","Charmeleon","Chandelure"]
"Cherrim"	["Delphox","Sizzlipede","Turtonator","Litten","Arcanine","Slugma","Reshiram","Moltres","Scorbunny","Chandelure"]
"Bronzor"	["Flareon","Charizard","Raboot","Monferno","Pansear","Darumaka","Centiskorch","Magmar","Litten","Ho-Oh"]
"Bronzong"	["Fennekin","Magcargo","Numel","Arcanine","Lampent","Pyroar","Litleo","Litten","Houndoom","Chimchar"]
"Lucario"	["Larvesta","Lampent","Vulpix","Slugma","Tepig","Fennekin","Growlithe","Houndour","Charmeleon","Camerupt"]
"Skorupi"	["Infernape","Slugma","Turtonator","Ponyta","Oricorio","Braixen","Ho-Oh","Darmanitan","Magcargo","Heatmor"]
"Carnivine"	["Magmar","Camerupt","Fletchinder","Litwick","Turtonator","Torkoal","Blacephalon","Emboar","Raboot","Ninetales"]
"Snover"	["Houndour","Torchic","Delphox","Chandelure","Typhlosion","Coalossal","Oricorio","Monferno","Chimchar","Litleo"]
"Abomasnow"	["Ho-Oh","Torchic","Quilava","Arcanine","Braixen","Torkoal","Litten","Charmeleon","Darmanitan","Coalossal"]
"Tangrowth"	["Fennekin","Darumaka","Centiskorch","Magcargo","Turtonator","Simisear","Pignite","Carkol","Cinderace","Arcanine"]
"Leafeon"	["Larvesta","Blaziken","Pansear","Monferno","Scorbunny","Rapidash","Magcargo","Coalossal","Magmar","Fletchinder"]
"Glaceon"	["Flareon","Coalossal","Incineroar","Chimchar","Scorbunny","Ho-Oh","Victini","Lampent","Numel","Centiskorch"]
"Mamoswine"	["Chandelure","Centiskorch","Lampent","Growlithe","Litten","Larvesta","Darmanitan","Charmander","Torchic","Pansear"]
"Froslass"	["Carkol","Heatmor","Darmanitan","Charmander","Tepig","Entei","Scorbunny","Raboot","Charizard","Heatran"]
"Shaymin"	["Simisear","Typhlosion","Volcarona","Quilava","Rapidash","Magcargo","Houndour","Salazzle","Pignite","Sizzlipede"]
"Snivy"	["Darmanitan","Sizzlipede","Pansear","Magcargo","Entei","Carkol","Numel","Houndoom","Litten","Ponyta"]
"Servine"	["Cyndaquil","Reshiram","Pignite","Heatmor","Torkoal","Houndour","Torchic","Pyroar","Charizard","Heatran"]
"Serperior"	["Larvesta","Ninetales","Camerupt","Cinderace","Talonflame","Darmanitan","Fennekin","Charmeleon","Arcanine","Raboot"]
"Pansage"	["Salazzle","Heatran","Charmander","Ninetales","Litten","Tepig","Typhlosion","Magmortar","Magby","Cyndaquil"]
"Simisage"	["Salazzle","Volcarona","Torchic","Pyroar","Lampent","Larvesta","Camerupt","Entei","Ponyta","Emboar"]
"Excadrill"	["Braixen","Arcanine","Oricorio","Darumaka","Darmanitan","Coalossal","Typhlosion","Litleo","Turtonator","Incineroar"]
"Sewaddle"	["Scorbunny","Centiskorch","Braixen","Torchic","Charmeleon","Charizard","Raboot","Numel","Vulpix","Darmanitan"]
"Swadloon"	["Ho-Oh","Monferno","Typhlosion","Raboot","Centiskorch","Ninetales","Fennekin","Torracat","Turtonator","Larvesta"]
"Leavanny"	["Torkoal","Magmortar","Houndoom","Entei","Turtonator","Ninetales","Torchic","Slugma","Litwick","Scorbunny"]
"Venipede"	["Simisear","Litleo","Quilava","Blaziken","Centiskorch","Reshiram","Chandelure","Charizard","Salandit","Cinderace"]
"Whirlipede"	["Fletchinder","Salandit","Houndour","Rapidash","Chandelure","Ponyta","Entei","Monferno","Quilava","Delphox"]
"Scolipede"	["Delphox","Camerupt","Heatmor","Lampent","Growlithe","Moltres","Litwick","Quilava","Magmortar","Victini"]
"Petilil"	["Incineroar","Growlithe","Charmeleon","Litten","Salandit","Braixen","Chimchar","Pignite","Litleo","Flareon"]
"Lilligant"	["Numel","Ho-Oh","Sizzlipede","Litten","Salazzle","Ninetales","Talonflame","Charmander","Larvesta","Centiskorch"]
"Maractus"	["Blaziken","Tepig","Blacephalon","Torracat","Ninetales","Arcanine","Simisear","Sizzlipede","Charmander","Torkoal"]
"Vanillite"	["Centiskorch","Arcanine","Raboot","Magmortar","Oricorio","Lampent","Salazzle","Incineroar","Fletchinder","Magmar"]
"Vanillish"	["Sizzlipede","Charmander","Incineroar","Monferno","Heatran","Blacephalon","Oricorio","Camerupt","Emboar","Ponyta"]
"Vanilluxe"	["Rapidash","Slugma","Raboot","Darumaka","Pignite","Numel","Tepig","Magcargo","Fennekin","Typhlosion"]
"Deerling"	["Incineroar","Vulpix","Victini","Slugma","Pignite","Carkol","Darmanitan","Litwick","Larvesta","Sizzlipede"]
"Sawsbuck"	["Flareon","Houndoom","Magmortar","Quilava","Simisear","Camerupt","Centiskorch","Fennekin","Chandelure","Magcargo"]
"Karrablast"	["Fletchinder","Magcargo","Flareon","Tepig","Entei","Ninetales","Litleo","Braixen","Vulpix","Torchic"]
"Escavalier"	["Coalossal","Charmeleon","Incineroar","Talonflame","Reshiram","Cinderace","Pansear","Braixen","Raboot","Victini"]
"Foongus"	["Magby","Arcanine","Houndoom","Magmortar","Torkoal","Charmeleon","Litleo","Camerupt","Raboot","Quilava"]
"Amoonguss"	["Carkol","Fennekin","Tepig","Quilava","Ho-Oh","Larvesta","Centiskorch","Raboot","Simisear","Victini"]
"Joltik"	["Scorbunny","Charmeleon","Numel","Sizzlipede","Oricorio","Torchic","Houndoom","Heatran","Entei","Flareon"]
"Galvantula"	["Ninetales","Emboar","Charmeleon","Magmortar","Oricorio","Fennekin","Charmander","Slugma","Cyndaquil","Scorbunny"]
"Ferroseed"	["Typhlosion","Simisear","Rapidash","Raboot","Litleo","Ho-Oh","Talonflame","Fletchinder","Oricorio","Infernape"]
"Ferrothorn"	["Larvesta","Incineroar","Charmeleon","Houndoom","Emboar","Entei","Blaziken","Charizard","Monferno","Pyroar"]
"Klink"	["Monferno","Ninetales","Combusken","Chimchar","Darumaka","Volcanion","Tepig","Talonflame","Numel","Larvesta"]
"Klang"	["Volcarona","Litleo","Quilava","Talonflame","Cyndaquil","Torracat","Litwick","Heatran","Chimchar","Torkoal"]
"Klinklang"	["Magby","Larvesta","Combusken","Moltres","Torchic","Houndour","Centiskorch","Quilava","Talonflame","Raboot"]
"Cubchoo"	["Braixen","Litleo","Scorbunny","Houndour","Flareon","Sizzlipede","Victini","Slugma","Volcanion","Talonflame"]
"Beartic"	["Magmar","Flareon","Litwick","Magmortar","Infernape","Magcargo","Ponyta","Volcanion","Heatran","Darumaka"]
"Cryogonal"	["Lampent","Magmortar","Infernape","Vulpix","Victini","Numel","Houndoom","Entei","Raboot","Darmanitan"]
"Shelmet"	["Salazzle","Braixen","Volcanion","Simisear","Fennekin","Heatran","Litten","Salandit","Camerupt","Litleo"]
"Accelgor"	["Heatran","Turtonator","Victini","Magmar","Fennekin","Centiskorch","Moltres","Cinderace","Chandelure","Cyndaquil"]
"Durant"	["Monferno","Magcargo","Fletchinder","Magby","Houndour","Incineroar","Simisear","Cinderace","Moltres","Oricorio"]
"Cobalion"	["Salandit","Torracat","Sizzlipede","Monferno","Typhlosion","Larvesta","Charmander","Fletchinder","Flareon","Numel"]
"Genesect"	["Torracat","Chimchar","Pignite","Pansear","Larvesta","Infernape","Houndoom","Fletchinder","Combusken","Moltres"]
"Chespin"	["Chandelure","Heatran","Salandit","Delphox","Blacephalon","Pansear","Typhlosion","Torracat","Houndour","Cyndaquil"]
"Quilladin"	["Houndour","Torchic","Litten","Centiskorch","Typhlosion","Charizard","Numel","Quilava","Raboot","Magby"]
"Scatterbug"	["Fletchinder","Victini","Infernape","Coalossal","Combusken","Litleo","Chandelure","Ponyta","Litten","Sizzlipede"]
"Spewpa"	["Volcanion","Numel","Cinderace","Victini","Houndoom","Coalossal","Chandelure","Combusken","Braixen","Magmortar"]
"Skiddo"	["Pansear","Pyroar","Cinderace","Blacephalon","Houndoom","Chandelure","Vulpix","Turtonator","Emboar","Litleo"]
"Gogoat"	["Magby","Salazzle","Combusken","Torracat","Magmortar","Houndour","Litleo","Litten","Blaziken","Raboot"]
"Honedge"	["Magmar","Scorbunny","Chandelure","Camerupt","Oricorio","Centiskorch","Charmander","Coalossal","Lampent","Ninetales"]
"Doublade"	["Torkoal","Salandit","Tepig","Litleo","Lampent","Chimchar","Houndour","Incineroar","Vulpix","Torchic"]
"Aegislash"	["Moltres","Heatmor","Talonflame","Pyroar","Magmar","Chimchar","Simisear","Sizzlipede","Charizard","Tepig"]
"Klefki"	["Cyndaquil","Darmanitan","Magcargo","Magmortar","Lampent","Entei","Talonflame","Litleo","Ho-Oh","Camerupt"]
"Phantump"	["Houndoom","Darmanitan","Ninetales","Litwick","Slugma","Turtonator","Torchic","Cinderace","Darumaka","Volcarona"]
"Trevenant"	["Litwick","Monferno","Torracat","Blacephalon","Houndour","Slugma","Combusken","Delphox","Fletchinder","Pansear"]
"Pumpkaboo"	["Incineroar","Charmeleon","Cyndaquil","Volcarona","Braixen","Litwick","Tepig","Torchic","Blacephalon","Salandit"]
"Gourgeist"	["Torkoal","Salazzle","Infernape","Rapidash","Ho-Oh","Magmortar","Victini","Talonflame","Heatmor","Torracat"]
"Bergmite"	["Rapidash","Typhlosion","Pignite","Magcargo","Infernape","Pansear","Talonflame","Delphox","Reshiram","Camerupt"]
"Avalugg"	["Magby","Typhlosion","Fletchinder","Litwick","Blacephalon","Quilava","Charmeleon","Centiskorch","Torchic","Infernape"]
"Decidueye"	["Typhlosion","Tepig","Blaziken","Arcanine","Magcargo","Pyroar","Cyndaquil","Chandelure","Magmortar","Ponyta"]
"Grubbin"	["Numel","Growlithe","Victini","Darumaka","Sizzlipede","Chimchar","Fennekin","Tepig","Talonflame","Scorbunny"]
"Charjabug"	["Darmanitan","Tepig","Torchic","Cyndaquil","Carkol","Arcanine","Heatmor","Delphox","Camerupt","Volcanion"]
"Vikavolt"	["Cyndaquil","Pignite","Magmar","Emboar","Darmanitan","Rapidash","Salandit","Ponyta","Tepig","Litten"]
"Crabominable"	["Rapidash","Raboot","Volcanion","Houndour","Delphox","Infernape","Chimchar","Magmortar","Combusken","Torchic"]
"Cutiefly"	["Pansear","Magmar","Salandit","Arcanine","Vulpix","Turtonator","Blacephalon","Fennekin","Litwick","Simisear"]
"Ribombee"	["Volcarona","Chimchar","Carkol","Ho-Oh","Sizzlipede","Litten","Heatran","Blaziken","Typhlosion","Litleo"]
"Fomantis"	["Pignite","Chandelure","Delphox","Volcanion","Oricorio","Cyndaquil","Carkol","Litwick","Ho-Oh","Incineroar"]
"Lurantis"	["Heatmor","Raboot","Pignite","Darmanitan","Sizzlipede","Houndour","Incineroar","Simisear","Pyroar","Entei"]
"Bounsweet"	["Carkol","Braixen","Coalossal","Charizard","Arcanine","Lampent","Chimchar","Charmander","Torracat","Torkoal"]
"Steenee"	["Reshiram","Larvesta","Incineroar","Oricorio","Fennekin","Camerupt","Infernape","Centiskorch","Ninetales","Torracat"]
"Tsareena"	["Simisear","Tepig","Darumaka","Magmar","Charizard","Reshiram","Pignite","Carkol","Raboot","Typhlosion"]
"Dhelmise"	["Ninetales","Flareon","Chimchar","Chandelure","Salazzle","Centiskorch","Typhlosion","Oricorio","Salandit","Coalossal"]
"Solgaleo"	["Tepig","Pansear","Houndoom","Emboar","Victini","Ninetales","Reshiram","Lampent","Chandelure","Fletchinder"]
"Celesteela"	["Braixen","Quilava","Cinderace","Charmander","Combusken","Numel","Heatmor","Reshiram","Incineroar","Rapidash"]
"Magearna"	["Rapidash","Magcargo","Darumaka","Monferno","Larvesta","Talonflame","Torchic","Ponyta","Typhlosion","Reshiram"]
"Meltan"	["Salandit","Volcanion","Torkoal","Emboar","Quilava","Volcarona","Magby","Oricorio","Litleo","Pyroar"]
"Melmetal"	["Litwick","Blacephalon","Fletchinder","Magcargo","Heatmor","Pyroar","Charizard","Combusken","Delphox","Reshiram"]
"Grookey"	["Rapidash","Camerupt","Victini","Vulpix","Braixen","Cinderace","Torkoal","Pyroar","Charmeleon","Blaziken"]
"Thwackey"	["Numel","Cyndaquil","Monferno","Quilava","Vulpix","Volcarona","Sizzlipede","Entei","Heatmor","Houndour"]
"Rillaboom"	["Centiskorch","Torkoal","Ho-Oh","Pansear","Infernape","Cinderace","Fletchinder","Charizard","Sizzlipede","Houndoom"]
"Corviknight"	["Torkoal","Torracat","Magmar","Darmanitan","Litten","Emboar","Lampent","Torchic","Tepig","Salazzle"]
"Blipbug"	["Heatmor","Fennekin","Magcargo","Scorbunny","Salandit","Torracat","Arcanine","Cinderace","Houndoom","Litwick"]
"Dottler"	["Combusken","Darumaka","Torracat","Quilava","Fennekin","Magmar","Ninetales","Heatmor","Sizzlipede","Centiskorch"]
"Orbeetle"	["Growlithe","Ponyta","Combusken","Raboot","Quilava","Heatran","Chimchar","Oricorio","Volcarona","Typhlosion"]
"Gossifleur"	["Reshiram","Braixen","Heatran","Larvesta","Charmeleon","Houndour","Combusken","Magcargo","Quilava","Flareon"]
"Eldegoss"	["Chandelure","Magmortar","Scorbunny","Victini","Torkoal","Charmander","Vulpix","Charmeleon","Raboot","Ho-Oh"]
"Perrserker"	["Litleo","Rapidash","Tepig","Slugma","Houndoom","Turtonator","Fennekin","Camerupt","Fletchinder","Lampent"]
"Mr. Rime"	["Entei","Chimchar","Slugma","Torchic","Centiskorch","Houndour","Infernape","Carkol","Coalossal","Fletchinder"]
"Snom"	["Chimchar","Typhlosion","Rapidash","Magby","Simisear","Litten","Coalossal","Talonflame","Darmanitan","Magmar"]
"Frosmoth"	["Cinderace","Scorbunny","Ninetales","Volcanion","Victini","Centiskorch","Magmortar","Sizzlipede","Oricorio","Salazzle"]
"Eiscue"	["Growlithe","Moltres","Torkoal","Salandit","Raboot","Chimchar","Monferno","Rapidash","Vulpix","Scorbunny"]
"Cufant"	["Fennekin","Numel","Moltres","Growlithe","Pignite","Carkol","Larvesta","Magmar","Talonflame","Litten"]
"Copperajah"	["Charizard","Simisear","Houndoom","Chandelure","Magmortar","Torkoal","Moltres","Delphox","Camerupt","Victini"]
"Arctozolt"	["Volcanion","Victini","Houndoom","Litten","Coalossal","Centiskorch","Pignite","Raboot","Fletchinder","Cinderace"]
"Glastrier"	["Numel","Incineroar","Ninetales","Braixen","Centiskorch","Camerupt","Delphox","Scorbunny","Pignite","Charizard"]
"Mankey"	["Swoobat","Natu","Fearow","Gliscor","Zapdos","Rufflet","Chatot","Articuno","Pidgey","Yanma"]
"Primeape"	["Mantyke","Crobat","Moltres","Pelipper","Swoobat","Dartrix","Vullaby","Spearow","Gyarados","Scyther"]
"Machop"	["Yveltal","Ledian","Wingull","Altaria","Xatu","Staraptor","Fearow","Tornadus","Yanmega","Togekiss"]
"Machoke"	["Murkrow","Vullaby","Pidgeot","Crobat","Scyther","Noivern","Hoppip","Trumbeak","Dragonite","Masquerain"]
"Machamp"	["Noibat","Corviknight","Woobat","Rayquaza","Dartrix","Pelipper","Staravia","Togekiss","Gligar","Tropius"]
"Hitmonlee"	["Altaria","Starly","Togekiss","Ledian","Xatu","Swablu","Natu","Pidgeot","Farfetch'd","Pidove"]
"Hitmonchan"	["Mantine","Yanma","Talonflame","Ho-Oh","Mantyke","Vivillon","Articuno","Staraptor","Braviary","Ledyba"]
"Heracross"	["Noctowl","Landorus","Chatot","Trumbeak","Corvisquire","Moltres","Braviary","Mantine","Articuno","Salamence"]
"Tyrogue"	["Pidgeotto","Ledyba","Skiploom","Dartrix","Swablu","Thundurus","Masquerain","Natu","Tranquill","Pidgeot"]
"Hitmontop"	["Woobat","Xatu","Lugia","Farfetch'd","Mandibuzz","Swellow","Articuno","Salamence","Gyarados","Butterfree"]
"Breloom"	["Ho-Oh","Gyarados","Landorus","Aerodactyl","Tropius","Combee","Skiploom","Pidgeotto","Thundurus","Noibat"]
"Makuhita"	["Tropius","Drifblim","Mothim","Skarmory","Yveltal","Oricorio","Pelipper","Golbat","Toucannon","Togetic"]
"Hariyama"	["Drifblim","Trumbeak","Mantyke","Pidgeotto","Moltres","Altaria","Hoppip","Farfetch'd","Minior","Tranquill"]
"Meditite"	["Taillow","Ho-Oh","Gligar","Ledyba","Wingull","Gliscor","Charizard","Swellow","Talonflame","Rayquaza"]
"Medicham"	["Yanmega","Delibird","Landorus","Togetic","Honchkrow","Fletchling","Archen","Woobat","Hoppip","Swellow"]
"Riolu"	["Staraptor","Ho-Oh","Toucannon","Zapdos","Pidgeotto","Sigilyph","Fearow","Swoobat","Delibird","Celesteela"]
"Gallade"	["Rufflet","Zapdos","Swablu","Corviknight","Hawlucha","Hoothoot","Delibird","Thundurus","Staraptor","Yanmega"]
"Timburr"	["Braviary","Zapdos","Ledyba","Mantine","Zubat","Thundurus","Gyarados","Noivern","Wingull","Hoothoot"]
"Gurdurr"	["Gligar","Talonflame","Archeops","Emolga","Skiploom","Pikipek","Tranquill","Ninjask","Starly","Chatot"]
"Conkeldurr"	["Skarmory","Fletchling","Noivern","Woobat","Pidgeot","Swanna","Togetic","Celesteela","Dragonite","Hoppip"]
"Throh"	["Drifblim","Pidgeotto","Noctowl","Togekiss","Corvisquire","Aerodactyl","Thundurus","Butterfree","Mothim","Fletchling"]
"Sawk"	["Minior","Chatot","Starly","Unfezant","Talonflame","Natu","Mantine","Fletchling","Dodrio","Ledyba"]
"Mienfoo"	["Woobat","Noibat","Scyther","Tropius","Delibird","Vespiquen","Moltres","Articuno","Dodrio","Aerodactyl"]
"Mienshao"	["Thundurus","Aerodactyl","Jumpluff","Archen","Noibat","Gligar","Togetic","Ninjask","Beautifly","Mantyke"]
"Virizion"	["Dartrix","Pikipek","Pelipper","Staraptor","Drifloon","Emolga","Noivern","Jumpluff","Spearow","Swellow"]
"Chesnaught"	["Natu","Mothim","Sigilyph","Ho-Oh","Salamence","Honchkrow","Mantine","Noivern","Staraptor","Ledian"]
"Pancham"	["Aerodactyl","Swanna","Tranquill","Tropius","Woobat","Spearow","Hoppip","Pidgeot","Swoobat","Farfetch'd"]
"Crabrawler"	["Natu","Braviary","Delibird","Rufflet","Mantine","Corviknight","Swanna","Gliscor","Trumbeak","Noivern"]
"Passimian"	["Archen","Fearow","Togetic","Toucannon","Dragonite","Rookidee","Pelipper","Dartrix","Crobat","Hawlucha"]
"Buzzwole"	["Swoobat","Jumpluff","Drifloon","Skiploom","Talonflame","Swablu","Vivillon","Golbat","Salamence","Aerodactyl"]
"Pheromosa"	["Pelipper","Pidgey","Zubat","Ninjask","Cramorant","Zapdos","Doduo","Yveltal","Hoppip","Sigilyph"]
"Marshadow"	["Farfetch'd","Ledian","Pidgeot","Fletchling","Golbat","Corvisquire","Butterfree","Hawlucha","Zapdos","Mantyke"]
"Clobbopus"	["Mantine","Golbat","Scyther","Tornadus","Staraptor","Sigilyph","Farfetch'd","Landorus","Moltres","Archen"]
"Grapploct"	["Combee","Yveltal","Sigilyph","Pidgeotto","Vivillon","Taillow","Tropius","Wingull","Hoothoot","Altaria"]
"Sirfetch'd"	["Lugia","Rookidee","Crobat","Farfetch'd","Vespiquen","Ledian","Butterfree","Staraptor","Combee","Golbat"]
"Falinks"	["Braviary","Ducklett","Farfetch'd","Combee","Fletchling","Hawlucha","Zubat","Gligar","Pelipper","Togetic"]
"Zamazenta"	["Tranquill","Dartrix","Noctowl","Combee","Sigilyph","Ninjask","Toucannon","Hoppip","Golbat","Noibat"]
"Kubfu"	["Zapdos","Crobat","Swablu","Salamence","Vullaby","Pelipper","Tropius","Vivillon","Rufflet","Articuno"]
"Misdreavus"	["Blacephalon","Haunter","Misdreavus","Drakloak","Golurk","Decidueye","Gourgeist","Hoopa","Lampent","Honedge"]
"Shuppet"	["Aegislash","Lunala","Spiritomb","Spectrier","Drifblim","Misdreavus","Dusclops","Gengar","Marshadow","Frillish"]
"Banette"	["Dreepy","Drakloak","Dragapult","Gourgeist","Honedge","Jellicent","Lampent","Dusknoir","Spectrier","Runerigus"]
"Duskull"	["Duskull","Hoopa","Sandygast","Sableye","Honedge","Dragapult","Dreepy","Gourgeist","Rotom","Blacephalon"]
"Dusclops"	["Phantump","Haunter","Shuppet","Dhelmise","Gourgeist","Trevenant","Golurk","Rotom","Froslass","Lunala"]
"Mismagius"	["Sinistea","Spectrier","Giratina","Cursola","Dhelmise","Golurk","Trevenant","Duskull","Sableye","Yamask"]
"Dusknoir"	["Pumpkaboo","Gengar","Spiritomb","Mismagius","Gourgeist","Blacephalon","Palossand","Mimikyu","Cursola","Dragapult"]
"Yamask"	["Palossand","Jellicent","Drifblim","Shedinja","Spectrier","Lunala","Spiritomb","Cursola","Froslass","Cofagrigus"]
"Cofagrigus"	["Gastly","Chandelure","Froslass","Mimikyu","Yamask","Frillish","Lampent","Shuppet","Golett","Lunala"]
"Hoopa"	["Golett","Mismagius","Sandygast","Lunala","Hoopa","Blacephalon","Dragapult","Froslass","Drifblim","Misdreavus"]
"Mimikyu"	["Shedinja","Doublade","Mimikyu","Giratina","Cursola","Mismagius","Litwick","Lampent","Sinistea","Gengar"]
"Lunala"	["Litwick","Cofagrigus","Gengar","Mimikyu","Drifblim","Cursola","Palossand","Sinistea","Drifloon","Mismagius"]
"Sinistea"	["Shuppet","Chandelure","Dhelmise","Dusknoir","Litwick","Dreepy","Gourgeist","Misdreavus","Mimikyu","Duskull"]
"Cursola"	["Cursola","Phantump","Pumpkaboo","Spectrier","Marshadow","Dhelmise","Hoopa","Lunala","Shuppet","Dusclops"]
"Spectrier"	["Litwick","Blacephalon","Misdreavus","Aegislash","Duskull","Drifloon","Drakloak","Hoopa","Phantump","Mimikyu"]
"Omanyte"	["Skiddo","Grovyle","Venusaur","Ludicolo","Roserade","Lileep","Sceptile","Phantump","Lombre","Applin"]
"Omastar"	["Lurantis","Seedot","Exeggutor","Chespin","Phantump","Decidueye","Cherrim","Dartrix","Treecko","Ferrothorn"]
"Kabuto"	["Sunflora","Gogoat","Bellsprout","Seedot","Pansage","Shaymin","Turtwig","Whimsicott","Sewaddle","Gourgeist"]
"Kabutops"	["Cherrim","Virizion","Cottonee","Tropius","Servine","Shiftry","Skiddo","Snover","Petilil","Sunflora"]
"Chinchou"	["Eldegoss","Dartrix","Vileplume","Ferroseed","Chikorita","Chespin","Gogoat","Decidueye","Ludicolo","Weepinbell"]
"Lanturn"	["Hoppip","Cottonee","Appletun","Flapple","Torterra","Cacturne","Sunflora","Nuzleaf","Bulbasaur","Oddish"]
"Wooper"	["Rillaboom","Simisage","Shaymin","Lilligant","Sunflora","Fomantis","Quilladin","Serperior","Exeggcute","Phantump"]
"Quagsire"	["Zarude","Ferroseed","Shroomish","Tsareena","Roselia","Roserade","Amoonguss","Ferrothorn","Budew","Fomantis"]
"Corsola"	["Snover","Hoppip","Bellossom","Thwackey","Skiddo","Sunkern","Lileep","Whimsicott","Applin","Exeggutor"]
"Marshtomp"	["Cottonee","Maractus","Fomantis","Carnivine","Tangrowth","Decidueye","Calyrex","Sunkern","Ferrothorn","Gloom"]
"Swampert"	["Chesnaught","Zarude","Chespin","Sawsbuck","Cradily","Shiftry","Appletun","Weepinbell","Ivysaur","Cherrim"]
"Barboach"	["Breloom","Nuzleaf","Whimsicott","Paras","Eldegoss","Amoonguss","Zarude","Leafeon","Sewaddle","Rillaboom"]
"Whiscash"	["Petilil","Shiftry","Flapple","Ivysaur","Grotle","Fomantis","Tangela","Sceptile","Applin","Grookey"]
"Relicanth"	["Phantump","Foongus","Shaymin","Amoonguss","Leafeon","Snivy","Ferrothorn","Sewaddle","Lotad","Chesnaught"]
"Gastrodon"	["Ivysaur","Sunflora","Sunkern","Leavanny","Exeggutor","Cherrim","Gogoat","Snivy","Lileep","Simisage"]
"Palpitoad"	["Simisage","Bulbasaur","Skiddo","Tropius","Chesnaught","Meganium","Pumpkaboo","Gossifleur","Oddish","Tsareena"]
"Seismitoad"	["Bellsprout","Bulbasaur","Snover","Cottonee","Meganium","Whimsicott","Pumpkaboo","Ludicolo","Sunkern","Breloom"]
"Tirtouga"	["Wormadam","Shroomish","Nuzleaf","Paras","Chesnaught","Hoppip","Ferroseed","Shiinotic","Tangela","Cottonee"]
"Carracosta"	["Cradily","Vileplume","Hoppip","Seedot","Meganium","Lombre","Decidueye","Sunflora","Skiddo","Ferrothorn"]
"Binacle"	["Celebi","Gossifleur","Chesnaught","Snover","Flapple","Grookey","Applin","Shroomish","Rillaboom","Roselia"]
"Barbaracle"	["Tsareena","Decidueye","Calyrex","Lombre","Breloom","Carnivine","Snivy","Tangela","Roserade","Cradily"]
"Drednaw"	["Lombre","Shiftry","Torterra","Bellsprout","Cacnea","Swadloon","Chespin","Chesnaught","Pumpkaboo","Foongus"]
"Ekans"	["Krookodile","Gible","Barboach","Hippowdon","Sandslash","Diggersby","Stunfisk","Hippopotas","Nincada","Swampert"]
"Arbok"	["Gliscor","Nidoking","Krokorok","Golem","Krookodile","Sandaconda","Drilbur","Diggersby","Quagsire","Runerigus"]
"Pikachu"	["Sandslash","Palossand","Krookodile","Zygarde","Gible","Piloswine","Hippopotas","Sandaconda","Baltoy","Mudbray"]
"Raichu"	["Mudbray","Mamoswine","Silicobra","Phanpy","Krookodile","Golem","Dugtrio","Donphan","Gible","Steelix"]
"Nidoran FEMALE"	["Vibrava","Sandslash","Rhydon","Sandygast","Golem","Sandaconda","Flygon","Mamoswine","Runerigus","Nidoking"]
"Nidorina"	["Groudon","Swampert","Golem","Nincada","Piloswine","Diglett","Rhydon","Hippopotas","Dugtrio","Mudbray"]
"Nidoran MALE"	["Mamoswine","Wooper","Phanpy","Golett","Hippopotas","Sandaconda","Geodude","Sandshrew","Silicobra","Gligar"]
"Nidorino"	["Onix","Swinub","Torterra","Nidoking","Golurk","Silicobra","Krookodile","Cubone","Trapinch","Sandygast"]
"Magnemite"	["Krokorok","Claydol","Numel","Swinub","Palossand","Golurk","Sandaconda","Larvitar","Hippopotas","Cubone"]
"Magneton"	["Wooper","Diggersby","Nincada","Camerupt","Krookodile","Barboach","Numel","Baltoy","Vibrava","Geodude"]
"Grimer"	["Sandygast","Palossand","Excadrill","Geodude","Vibrava","Pupitar","Whiscash","Golurk","Quagsire","Baltoy"]
"Muk"	["Larvitar","Trapinch","Hippowdon","Steelix","Seismitoad","Palossand","Baltoy","Phanpy","Palpitoad","Mudbray"]
"Gastly"	["Palossand","Trapinch","Sandile","Dugtrio","Diggersby","Onix","Excadrill","Vibrava","Swampert","Quagsire"]
"Haunter"	["Trapinch","Geodude","Gabite","Krookodile","Mudbray","Sandshrew","Larvitar","Swinub","Golett","Phanpy"]
"Gengar"	["Steelix","Sandile","Krookodile","Hippopotas","Mudsdale","Larvitar","Runerigus","Seismitoad","Drilbur","Claydol"]
"Voltorb"	["Steelix","Palossand","Trapinch","Sandygast","Graveler","Drilbur","Rhydon","Palpitoad","Gligar","Krokorok"]
"Electrode"	["Quagsire","Phanpy","Zygarde","Hippowdon","Pupitar","Mudsdale","Barboach","Rhydon","Larvitar","Flygon"]
"Koffing"	["Larvitar","Landorus","Piloswine","Nidoking","Gible","Gligar","Phanpy","Sandygast","Vibrava","Seismitoad"]
"Weezing"	["Cubone","Wooper","Piloswine","Rhydon","Garchomp","Mamoswine","Onix","Nidoking","Hippopotas","Golett"]
"Electabuzz"	["Larvitar","Marshtomp","Golurk","Claydol","Golem","Cubone","Swinub","Gastrodon","Excadrill","Flygon"]
"Jolteon"	["Graveler","Whiscash","Cubone","Gliscor","Runerigus","Numel","Gabite","Phanpy","Golem","Garchomp"]
"Pichu"	["Diglett","Golett","Donphan","Runerigus","Whiscash","Larvitar","Geodude","Cubone","Silicobra","Numel"]
"Mareep"	["Groudon","Swinub","Donphan","Trapinch","Gligar","Sandslash","Graveler","Baltoy","Seismitoad","Camerupt"]
"Flaaffy"	["Gastrodon","Sandaconda","Onix","Trapinch","Dugtrio","Zygarde","Marowak","Diggersby","Mudbray","Phanpy"]
"Ampharos"	["Stunfisk","Cubone","Sandile","Flygon","Baltoy","Krookodile","Barboach","Seismitoad","Gligar","Marowak"]
"Elekid"	["Sandslash","Mudbray","Camerupt","Rhyhorn","Sandile","Silicobra","Larvitar","Zygarde","Rhyperior","Baltoy"]
"Raikou"	["Excadrill","Dugtrio","Hippowdon","Phanpy","Golem","Marshtomp","Quagsire","Diggersby","Piloswine","Donphan"]
"Electrike"	["Silicobra","Marowak","Dugtrio","Nidoqueen","Flygon","Gligar","Sandslash","Groudon","Pupitar","Gastrodon"]
"Manectric"	["Hippopotas","Pupitar","Stunfisk","Sandaconda","Groudon","Larvitar","Camerupt","Phanpy","Sandygast","Nincada"]
"Plusle"	["Wooper","Graveler","Diglett","Hippowdon","Landorus","Golett","Palossand","Gible","Dugtrio","Sandygast"]
"Minun"	["Quagsire","Landorus","Barboach","Marowak","Zygarde","Numel","Gliscor","Rhydon","Excadrill","Swampert"]
"Gulpin"	["Marshtomp","Cubone","Vibrava","Krokorok","Krookodile","Drilbur","Gible","Donphan","Claydol","Landorus"]
"Swalot"	["Gible","Stunfisk","Gabite","Sandslash","Marowak","Seismitoad","Donphan","Nincada","Golett","Piloswine"]
"Seviper"	["Gligar","Dugtrio","Seismitoad","Hippowdon","Rhyhorn","Palossand","Claydol","Nidoqueen","Garchomp","Sandslash"]
"Shinx"	["Garchomp","Nidoqueen","Marowak","Palpitoad","Flygon","Cubone","Rhyhorn","Golem","Krookodile","Gliscor"]
"Luxio"	["Nidoking","Drilbur","Numel","Sandslash","Diglett","Donphan","Dugtrio","Nincada","Gible","Excadrill"]
"Luxray"	["Landorus","Runerigus","Sandile","Palpitoad","Marshtomp","Sandslash","Sandaconda","Groudon","Phanpy","Larvitar"]
"Pachirisu"	["Sandygast","Stunfisk","Marshtomp","Hippopotas","Nidoking","Diglett","Quagsire","Golurk","Groudon","Barboach"]
"Stunky"	["Krokorok","Nidoking","Zygarde","Palpitoad","Gligar","Sandaconda","Golurk","Diggersby","Marshtomp","Larvitar"]
"Skuntank"	["Steelix","Swampert","Palossand","Swinub","Gabite","Excadrill","Gligar","Diggersby","Mudsdale","Donphan"]
"Drapion"	["Onix","Zygarde","Nidoking","Krokorok","Gliscor","Hippopotas","Nidoqueen","Golurk","Runerigus","Graveler"]
"Magnezone"	["Drilbur","Claydol","Excadrill","Mamoswine","Torterra","Flygon","Sandshrew","Nidoqueen","Nincada","Rhydon"]
"Electivire"	["Marowak","Krokorok","Larvitar","Gabite","Rhyhorn","Golett","Rhyperior","Gible","Steelix","Swinub"]
"Rotom"	["Rhydon","Rhyperior","Onix","Runerigus","Gible","Hippopotas","Marowak","Dugtrio","Numel","Larvitar"]
"Heatran"	["Marowak","Sandygast","Graveler","Seismitoad","Golurk","Sandile","Hippopotas","Diglett","Numel","Gible"]
"Blitzle"	["Swinub","Diggersby","Sandygast","Palpitoad","Runerigus","Gible","Excadrill","Baltoy","Marowak","Swampert"]
"Zebstrika"	["Swinub","Garchomp","Zygarde","Rhyhorn","Mamoswine","Camerupt","Nidoqueen","Marshtomp","Diggersby","Baltoy"]
"Trubbish"	["Onix","Sandslash","Krookodile","Stunfisk","Mamoswine","Dugtrio","Marowak","Runerigus","Drilbur","Swampert"]
"Garbodor"	["Gible","Rhyhorn","Rhyperior","Dugtrio","Drilbur","Baltoy","Torterra","Camerupt","Vibrava","Trapinch"]
"Tynamo"	["Piloswine","Pupitar","Seismitoad","Rhydon","Trapinch","Palpitoad","Numel","Golem","Hippowdon","Golett"]
"Eelektrik"	["Groudon","Rhyperior","Vibrava","Pupitar","Gible","Sandslash","Zygarde","Numel","Excadrill","Rhyhorn"]
"Eelektross"	["Landorus","Camerupt","Graveler","Rhyperior","Diggersby","Swinub","Numel","Hippopotas","Nidoking","Mamoswine"]
"Reshiram"	["Gligar","Excadrill","Nidoqueen","Mudsdale","Mudbray","Gible","Runerigus","Golett","Marshtomp","Stunfisk"]
"Salandit"	["Camerupt","Diglett","Sandslash","Baltoy","Gastrodon","Mudbray","Landorus","Swinub","Rhyhorn","Diggersby"]
"Salazzle"	["Diggersby","Sandaconda","Graveler","Gligar","Rhydon","Vibrava","Gastrodon","Hippowdon","Torterra","Mamoswine"]
"Turtonator"	["Nidoqueen","Stunfisk","Palossand","Baltoy","Whiscash","Numel","Trapinch","Flygon","Nincada","Sandshrew"]
"Togedemaru"	["Gliscor","Seismitoad","Graveler","Trapinch","Landorus","Garchomp","Sandaconda","Larvitar","Zygarde","Marowak"]
"Nihilego"	["Piloswine","Palossand","Donphan","Nidoqueen","Gliscor","Sandygast","Rhyperior","Palpitoad","Golurk","Flygon"]
"Xurkitree"	["Hippowdon","Onix","Mudsdale","Steelix","Marowak","Piloswine","Sandslash","Nincada","Palossand","Landorus"]
"Poipole"	["Marshtomp","Diglett","Rhydon","Silicobra","Groudon","Whiscash","Drilbur","Garchomp","Stunfisk","Steelix"]
"Zeraora"	["Nincada","Gliscor","Whiscash","Camerupt","Nidoking","Nidoqueen","Cubone","Hippowdon","Garchomp","Flygon"]
"Yamper"	["Mamoswine","Gastrodon","Dugtrio","Diglett","Nincada","Steelix","Gliscor","Claydol","Gligar","Larvitar"]
"Boltund"	["Golem","Excadrill","Dugtrio","Nidoqueen","Diggersby","Swampert","Mamoswine","Krokorok","Piloswine","Silicobra"]
"Toxel"	["Runerigus","Steelix","Geodude","Hippopotas","Stunfisk","Golem","Vibrava","Golurk","Gible","Garchomp"]
"Toxtricity"	["Seismitoad","Quagsire","Rhydon","Excadrill","Vibrava","Rhyhorn","Wooper","Gabite","Garchomp","Phanpy"]
"Pincurchin"	["Silicobra","Sandshrew","Drilbur","Landorus","Wooper","Hippopotas","Gible","Rhydon","Palossand","Diggersby"]
"Regieleki"	["Sandshrew","Gible","Hippowdon","Sandslash","Phanpy","Stunfisk","Palossand","Silicobra","Baltoy","Trapinch"]
"Zapdos"	["Vanillish","Snover","Froslass","Beartic","Dewgong","Lapras","Snom","Delibird","Kyurem","Bergmite"]
"Dratini"	["Jynx","Arctovish","Snover","Piloswine","Sneasel","Avalugg","Smoochum","Eiscue","Snom","Mamoswine"]
"Dragonair"	["Froslass","Mamoswine","Sneasel","Arctovish","Spheal","Glalie","Aurorus","Lapras","Abomasnow","Arctozolt"]
"Dragonite"	["Snom","Cubchoo","Mamoswine","Vanillite","Frosmoth","Arctovish","Regice","Articuno","Mr. Rime","Vanillish"]
"Hoppip"	["Glalie","Lapras","Crabominable","Amaura","Glaceon","Frosmoth","Articuno","Sealeo","Froslass","Delibird"]
"Skiploom"	["Snom","Arctovish","Dewgong","Vanillite","Smoochum","Amaura","Regice","Arctozolt","Vanilluxe","Abomasnow"]
"Jumpluff"	["Sealeo","Crabominable","Glastrier","Snom","Jynx","Articuno","Avalugg","Dewgong","Kyurem","Weavile"]
"Gligar"	["Jynx","Sneasel","Mamoswine","Arctovish","Piloswine","Snorunt","Eiscue","Mr. Rime","Vanillish","Glalie"]
"Vibrava"	["Cryogonal","Cubchoo","Mr. Rime","Arctozolt","Spheal","Bergmite","Vanillite","Articuno","Jynx","Snover"]
"Flygon"	["Piloswine","Cryogonal","Beartic","Glalie","Glastrier","Frosmoth","Sneasel","Mr. Rime","Snorunt","Crabominable"]
"Altaria"	["Glastrier","Crabominable","Snover","Piloswine","Aurorus","Mr. Rime","Sealeo","Dewgong","Vanilluxe","Froslass"]
"Lileep"	["Articuno","Lapras","Sneasel","Smoochum","Amaura","Glalie","Regice","Delibird","Avalugg","Arctozolt"]
"Cradily"	["Glaceon","Abomasnow","Mr. Rime","Cloyster","Articuno","Snom","Aurorus","Regice","Jynx","Spheal"]
"Tropius"	["Regice","Dewgong","Piloswine","Cubchoo","Spheal","Bergmite","Beartic","Snom","Swinub","Walrein"]
"Bagon"	["Sneasel","Kyurem","Mr. Rime","Glaceon","Arctovish","Arctozolt","Aurorus","Beartic","Cryogonal","Glalie"]
"Shelgon"	["Spheal","Arctovish","Snom","Eiscue","Swinub","Arctozolt","Mamoswine","Cryogonal","Snorunt","Kyurem"]
"Salamence"	["Swinub","Beartic","Delibird","Snover","Walrein","Weavile","Avalugg","Regice","Sneasel","Froslass"]
"Latias"	["Aurorus","Swinub","Kyurem","Cloyster","Spheal","Frosmoth","Sealeo","Amaura","Dewgong","Vanillish"]
"Latios"	["Froslass","Delibird","Eiscue","Swinub","Beartic","Cryogonal","Crabominable","Jynx","Smoochum","Aurorus"]
"Rayquaza"	["Snover","Smoochum","Spheal","Kyurem","Vanillish","Walrein","Dewgong","Glalie","Mr. Rime","Piloswine"]
"Torterra"	["Weavile","Glastrier","Abomasnow","Smoochum","Froslass","Vanilluxe","Regice","Beartic","Arctozolt","Dewgong"]
"Gible"	["Regice","Weavile","Avalugg","Walrein","Glalie","Cubchoo","Beartic","Sealeo","Cryogonal","Vanillite"]
"Gabite"	["Bergmite","Crabominable","Arctozolt","Lapras","Beartic","Glastrier","Delibird","Smoochum","Snom","Snorunt"]
"Garchomp"	["Weavile","Arctozolt","Aurorus","Dewgong","Delibird","Glalie","Abomasnow","Eiscue","Sneasel","Crabominable"]
"Gliscor"	["Cloyster","Arctovish","Regice","Snover","Snom","Arctozolt","Dewgong","Sneasel","Mr. Rime","Abomasnow"]
"Giratina"	["Froslass","Smoochum","Vanilluxe","Lapras","Eiscue","Glalie","Mamoswine","Piloswine","Articuno","Abomasnow"]
"Emolga"	["Bergmite","Mr. Rime","Arctozolt","Frosmoth","Mamoswine","Delibird","Snover","Vanillite","Amaura","Swinub"]
"Axew"	["Aurorus","Cloyster","Snover","Glastrier","Bergmite","Arctozolt","Dewgong","Cryogonal","Sealeo","Eiscue"]
"Fraxure"	["Cloyster","Arctovish","Piloswine","Glastrier","Snom","Arctozolt","Avalugg","Smoochum","Snover","Articuno"]
"Haxorus"	["Cloyster","Dewgong","Beartic","Piloswine","Cryogonal","Sealeo","Amaura","Lapras","Swinub","Snorunt"]
"Druddigon"	["Piloswine","Cryogonal","Sealeo","Frosmoth","Froslass","Crabominable","Arctozolt","Mr. Rime","Vanillite","Mamoswine"]
"Thundurus"	["Avalugg","Froslass","Smoochum","Bergmite","Mamoswine","Eiscue","Aurorus","Snom","Snover","Jynx"]
"Zekrom"	["Regice","Dewgong","Snover","Beartic","Weavile","Vanilluxe","Walrein","Vanillish","Cubchoo","Arctozolt"]
"Landorus"	["Snom","Snover","Swinub","Eiscue","Kyurem","Weavile","Aurorus","Articuno","Cryogonal","Arctozolt"]
"Dragalge"	["Eiscue","Froslass","Cubchoo","Bergmite","Vanillish","Amaura","Beartic","Walrein","Swinub","Abomasnow"]
"Tyrunt"	["Snorunt","Mr. Rime","Sneasel","Amaura","Cubchoo","Frosmoth","Articuno","Sealeo","Glalie","Cryogonal"]
"Tyrantrum"	["Mamoswine","Articuno","Snover","Swinub","Piloswine","Aurorus","Cubchoo","Delibird","Beartic","Sneasel"]
"Goomy"	["Cloyster","Swinub","Beartic","Sneasel","Walrein","Frosmoth","Arctozolt","Vanilluxe","Bergmite","Glalie"]
"Sliggoo"	["Beartic","Avalugg","Snom","Spheal","Glaceon","Arctozolt","Walrein","Aurorus","Cubchoo","Lapras"]
"Goodra"	["Cryogonal","Amaura","Dewgong","Snom","Arctovish","Sneasel","Mr. Rime","Abomasnow","Smoochum","Vanillish"]
"Noibat"	["Swinub","Avalugg","Froslass","Eiscue","Crabominable","Piloswine","Cubchoo","Abomasnow","Snorunt","Bergmite"]
"Noivern"	["Glastrier","Delibird","Cryogonal","Froslass","Abomasnow","Articuno","Arctovish","Kyurem","Swinub","Crabominable"]
"Zygarde"	["Kyurem","Sealeo","Cloyster","Sneasel","Snorunt","Eiscue","Lapras","Snom","Mamoswine","Glaceon"]
"Rowlet"	["Avalugg","Arctovish","Amaura","Kyurem","Mamoswine","Glaceon","Frosmoth","Vanillish","Vanilluxe","Cloyster"]
"Dartrix"	["Piloswine","Cryogonal","Cloyster","Amaura","Arctovish","Sneasel","Lapras","Jynx","Snover","Beartic"]
"Drampa"	["Smoochum","Cloyster","Weavile","Vanilluxe","Mamoswine","Cryogonal","Piloswine","Beartic","Sneasel","Spheal"]
"Jangmo-o"	["Vanillish","Snom","Vanillite","Mr. Rime","Crabominable","Smoochum","Piloswine","Walrein","Articuno","Lapras"]
"Naganadel"	["Arctozolt","Abomasnow","Weavile","Kyurem","Dewgong","Articuno","Snover","Eiscue","Amaura","Spheal"]
"Applin"	["Arctozolt","Cryogonal","Aurorus","Cloyster","Vanilluxe","Amaura","Mr. Rime","Frosmoth","Snover","Smoochum"]
"Flapple"	["Snom","Dewgong","Mr. Rime","Abomasnow","Cloyster","Crabominable","Beartic","Avalugg","Glastrier","Sneasel"]
"Appletun"	["Weavile","Crabominable","Regice","Aurorus","Piloswine","Dewgong","Glalie","Arctovish","Eiscue","Glaceon"]
"Dracozolt"	["Snover","Beartic","Spheal","Delibird","Lapras","Bergmite","Frosmoth","Abomasnow","Piloswine","Aurorus"]
"Dreepy"	["Delibird","Arctozolt","Crabominable","Glalie","Cubchoo","Frosmoth","Vanilluxe","Snover","Arctovish","Eiscue"]
"Drakloak"	["Snom","Sneasel","Vanillite","Regice","Abomasnow","Glalie","Mamoswine","Vanilluxe","Snorunt","Arctovish"]
"Dragapult"	["Spheal","Vanillish","Bergmite","Sealeo","Delibird","Arctovish","Amaura","Sneasel","Abomasnow","Smoochum"]
"Eternatus"	["Dewgong","Snom","Arctovish","Mr. Rime","Arctozolt","Cloyster","Spheal","Articuno","Glalie","Cubchoo"]
"Regidrago"	["Glastrier","Regice","Crabominable","Aurorus","Arctozolt","Kyurem","Cloyster","Dewgong","Vanillish","Smoochum"]
"Clefairy"	["Toxapex","Nidoran MALE","Zubat","Tentacool","Croagunk","Toxel","Golbat","Weezing","Nihilego","Venomoth"]
"Clefable"	["Weedle","Venomoth","Toxel","Drapion","Qwilfish","Gulpin","Croagunk","Ivysaur","Spinarak","Scolipede"]
"Jigglypuff"	["Kakuna","Mareanie","Gulpin","Budew","Koffing","Dragalge","Weedle","Trubbish","Ekans","Salazzle"]
"Wigglytuff"	["Zubat","Gengar","Bellsprout","Nidoking","Spinarak","Gulpin","Venusaur","Nidoqueen","Dragalge","Toxel"]
"Mr. Mime"	["Salazzle","Eternatus","Nihilego","Ivysaur","Koffing","Roselia","Dragalge","Croagunk","Salandit","Ekans"]
"Cleffa"	["Koffing","Arbok","Toxel","Dustox","Tentacruel","Eternatus","Zubat","Qwilfish","Bulbasaur","Drapion"]
"Igglybuff"	["Toxtricity","Toxel","Venipede","Whirlipede","Dragalge","Bellsprout","Crobat","Victreebel","Weedle","Beedrill"]
"Togepi"	["Muk","Nidoran MALE","Bulbasaur","Scolipede","Toxel","Nidorino","Nidorina","Garbodor","Poipole","Foongus"]
"Snubbull"	["Haunter","Salazzle","Golbat","Naganadel","Whirlipede","Roserade","Toxtricity","Nidorino","Zubat","Stunky"]
"Granbull"	["Kakuna","Gloom","Toxtricity","Venomoth","Weepinbell","Nidoran FEMALE","Grimer","Nidorina","Toxapex","Gulpin"]
"Lotad"	["Skuntank","Vileplume","Toxtricity","Oddish","Dragalge","Garbodor","Qwilfish","Bellsprout","Scolipede","Swalot"]
"Lombre"	["Skuntank","Gloom","Salandit","Skorupi","Crobat","Gengar","Nidoking","Muk","Budew","Grimer"]
"Ludicolo"	["Toxicroak","Nidoqueen","Muk","Gengar","Toxel","Venomoth","Nidorina","Toxtricity","Skuntank","Toxapex"]
"Ralts"	["Victreebel","Ariados","Zubat","Drapion","Bellsprout","Mareanie","Gloom","Amoonguss","Skuntank","Skorupi"]
"Kirlia"	["Ariados","Gloom","Scolipede","Vileplume","Nidoran FEMALE","Nihilego","Gengar","Bellsprout","Venipede","Beedrill"]
"Gardevoir"	["Venipede","Eternatus","Weedle","Koffing","Gengar","Amoonguss","Budew","Crobat","Mareanie","Ekans"]
"Azurill"	["Toxtricity","Salazzle","Stunky","Skuntank","Weepinbell","Toxapex","Vileplume","Koffing","Tentacruel","Toxicroak"]
"Mime Jr."	["Croagunk","Dragalge","Amoonguss","Crobat","Gloom","Venipede","Salandit","Swalot","Victreebel","Toxicroak"]
"Cottonee"	["Venipede","Gastly","Weepinbell","Roserade","Trubbish","Toxel","Foongus","Seviper","Drapion","Tentacruel"]
"Whimsicott"	["Beedrill","Spinarak","Crobat","Kakuna","Skuntank","Naganadel","Gengar","Poipole","Salandit","Nidoking"]
"Flabebe"	["Spinarak","Qwilfish","Salandit","Mareanie","Tentacool","Grimer","Stunky","Gulpin","Oddish","Nidorino"]
"Floette"	["Naganadel","Swalot","Qwilfish","Ariados","Nidorino","Haunter","Dustox","Nidoran FEMALE","Nihilego","Seviper"]
"Florges"	["Dragalge","Eternatus","Stunky","Ivysaur","Nidoran FEMALE","Toxtricity","Weedle","Beedrill","Bulbasaur","Venipede"]
"Spritzee"	["Nidoran MALE","Vileplume","Tentacool","Zubat","Gulpin","Skrelp","Crobat","Muk","Eternatus","Dragalge"]
"Aromatisse"	["Spinarak","Nidoking","Drapion","Toxapex","Croagunk","Weepinbell","Toxicroak","Gulpin","Bellsprout","Haunter"]
"Swirlix"	["Amoonguss","Nidorino","Dragalge","Eternatus","Toxtricity","Whirlipede","Grimer","Toxel","Spinarak","Zubat"]
"Slurpuff"	["Gengar","Victreebel","Dustox","Naganadel","Kakuna","Swalot","Nidoran MALE","Ivysaur","Toxtricity","Weezing"]
"Sylveon"	["Vileplume","Grimer","Garbodor","Weepinbell","Amoonguss","Gengar","Venonat","Weedle","Toxicroak","Nidoran FEMALE"]
"Dedenne"	["Eternatus","Muk","Venusaur","Dragalge","Ekans","Toxtricity","Nidorino","Salandit","Scolipede","Vileplume"]
"Xerneas"	["Skorupi","Trubbish","Skuntank","Gulpin","Weepinbell","Koffing","Toxel","Tentacruel","Venipede","Whirlipede"]
"Morelull"	["Croagunk","Stunky","Golbat","Roserade","Dustox","Toxapex","Nidorino","Trubbish","Gloom","Grimer"]
"Shiinotic"	["Skuntank","Koffing","Ekans","Dustox","Scolipede","Garbodor","Grimer","Nidoking","Gastly","Nihilego"]
"Comfey"	["Weedle","Victreebel","Roselia","Skuntank","Roserade","Weezing","Zubat","Dustox","Budew","Bulbasaur"]
"Tapu Koko"	["Trubbish","Salazzle","Skorupi","Beedrill","Seviper","Vileplume","Muk","Eternatus","Venipede","Dustox"]
"Tapu Lele"	["Dustox","Venusaur","Weedle","Gastly","Nidoqueen","Toxapex","Seviper","Ekans","Toxel","Roserade"]
"Tapu Bulu"	["Drapion","Venonat","Stunky","Tentacool","Ekans","Tentacruel","Toxapex","Roselia","Weedle","Croagunk"]
"Hatterene"	["Swalot","Gloom","Haunter","Qwilfish","Croagunk","Whirlipede","Nidoran FEMALE","Nidorina","Grimer","Nidoran MALE"]
"Impidimp"	["Toxtricity","Koffing","Venusaur","Gastly","Spinarak","Garbodor","Vileplume","Skuntank","Qwilfish","Amoonguss"]
"Morgrem"	["Skrelp","Gloom","Venusaur","Crobat","Swalot","Venonat","Croagunk","Whirlipede","Spinarak","Mareanie"]
"Grimmsnarl"	["Toxicroak","Whirlipede","Gastly","Venomoth","Croagunk","Venipede","Nidoran MALE","Weezing","Bulbasaur","Nidoqueen"]
"Milcery"	["Eternatus","Dragalge","Toxtricity","Dustox","Zubat","Koffing","Golbat","Nidorina","Gengar","Venipede"]
"Alcremie"	["Stunky","Victreebel","Nihilego","Gengar","Beedrill","Weepinbell","Grimer","Oddish","Toxel","Swalot"]
"Zacian"	["Crobat","Bellsprout","Venonat","Arbok","Mareanie","Zubat","Toxapex","Toxel","Venipede","Poipole"]
"Croagunk"	["Woobat","Mime Jr.","Meowstic","Necrozma","Chingling","Solrock","Spoink","Gothitelle","Oranguru","Dottler"]
"Toxicroak"	["Delphox","Slowpoke","Mesprit","Espurr","Meowstic","Lunala","Beldum","Baltoy","Latias","Gallade"]
"Charizard"	["Aurorus","Rolycoly","Rockruff","Lunatone","Rhyperior","Tyrantrum","Binacle","Shieldon","Nihilego","Gigalith"]
"Butterfree"	["Coalossal","Binacle","Geodude","Archeops","Diancie","Kabuto","Bonsly","Tyrantrum","Rhyhorn","Golem"]
"Scyther"	["Carbink","Stonjourner","Kabutops","Roggenrola","Sudowoodo","Rolycoly","Barbaracle","Solrock","Carkol","Cradily"]
"Articuno"	["Gigalith","Binacle","Probopass","Magcargo","Shuckle","Rockruff","Lairon","Tirtouga","Stonjourner","Tyrantrum"]
"Moltres"	["Lunatone","Cranidos","Graveler","Larvitar","Crustle","Bastiodon","Stakataka","Drednaw","Geodude","Pupitar"]
"Ledyba"	["Relicanth","Binacle","Rockruff","Omanyte","Corsola","Nosepass","Lairon","Anorith","Rhydon","Pupitar"]
"Ledian"	["Tyranitar","Aron","Bonsly","Rhydon","Rockruff","Binacle","Nihilego","Gigalith","Carracosta","Tyrunt"]
"Yanma"	["Carkol","Nosepass","Probopass","Coalossal","Onix","Tyrantrum","Barbaracle","Gigalith","Aggron","Aron"]
"Delibird"	["Bonsly","Tyrunt","Lairon","Cradily","Rhyhorn","Stonjourner","Binacle","Probopass","Kabutops","Geodude"]
"Ho-Oh"	["Barbaracle","Aggron","Tirtouga","Magcargo","Regirock","Pupitar","Rhyperior","Kabuto","Binacle","Gigalith"]
"Beautifly"	["Carbink","Lycanroc","Shieldon","Golem","Tirtouga","Archen","Anorith","Sudowoodo","Roggenrola","Terrakion"]
"Masquerain"	["Carracosta","Regirock","Lunatone","Larvitar","Tyrantrum","Shuckle","Solrock","Aerodactyl","Archen","Relicanth"]
"Ninjask"	["Rhydon","Archeops","Graveler","Crustle","Carkol","Cradily","Regirock","Lycanroc","Aron","Terrakion"]
"Mothim"	["Roggenrola","Barbaracle","Rolycoly","Amaura","Omanyte","Larvitar","Anorith","Carracosta","Crustle","Shieldon"]
"Combee"	["Anorith","Roggenrola","Coalossal","Rhyhorn","Cranidos","Stonjourner","Graveler","Crustle","Kabutops","Aerodactyl"]
"Vespiquen"	["Archeops","Relicanth","Dwebble","Aerodactyl","Coalossal","Carkol","Tyrantrum","Cranidos","Carracosta","Tyrunt"]
"Yanmega"	["Shieldon","Sudowoodo","Pupitar","Gigalith","Tyranitar","Kabuto","Coalossal","Tyrantrum","Golem","Tyrunt"]
"Larvesta"	["Carkol","Rampardos","Sudowoodo","Tyrunt","Dwebble","Carracosta","Probopass","Gigalith","Corsola","Bastiodon"]
"Volcarona"	["Drednaw","Nihilego","Roggenrola","Rhyperior","Magcargo","Cranidos","Relicanth","Archeops","Rhydon","Aron"]
"Fletchinder"	["Drednaw","Tyrantrum","Solrock","Sudowoodo","Nihilego","Lunatone","Omastar","Rhyperior","Bonsly","Probopass"]
"Talonflame"	["Nosepass","Rockruff","Rhyperior","Tyranitar","Geodude","Aerodactyl","Omastar","Graveler","Lunatone","Probopass"]
"Vivillon"	["Binacle","Omastar","Tyrantrum","Sudowoodo","Rhyhorn","Aggron","Carkol","Stakataka","Nosepass","Boldore"]
"Oricorio"	["Dwebble","Diancie","Lycanroc","Tyrunt","Kabuto","Lairon","Relicanth","Amaura","Graveler","Nihilego"]
"Sizzlipede"	["Drednaw","Carracosta","Lunatone","Omanyte","Shieldon","Tyrantrum","Carbink","Lileep","Kabuto","Aron"]
"Centiskorch"	["Archen","Cradily","Binacle","Boldore","Archeops","Tyrantrum","Sudowoodo","Rhydon","Rolycoly","Roggenrola"]
"Carbink"	["Duraludon","Steelix","Doublade","Bisharp","Bastiodon","Melmetal","Lucario","Cufant","Aggron","Aegislash"]
"Diancie"	["Perrserker","Magearna","Klang","Klinklang","Metang","Lairon","Stakataka","Durant","Meltan","Steelix"]
"Charmander"	["Corphish","Wartortle","Arctovish","Wailord","Pyukumuku","Horsea","Totodile","Floatzel","Kingdra","Luvdisc"]
"Charmeleon"	["Frillish","Clamperl","Omastar","Suicune","Samurott","Sobble","Dewgong","Krabby","Poliwrath","Crawdaunt"]
"Sandshrew"	["Omastar","Oshawott","Wailmer","Slowpoke","Primarina","Tentacruel","Seismitoad","Dewgong","Poliwhirl","Surskit"]
"Sandslash"	["Drizzile","Cloyster","Jellicent","Clamperl","Gorebyss","Goldeen","Poliwhirl","Mareanie","Clauncher","Inteleon"]
"Nidoqueen"	["Lapras","Blastoise","Psyduck","Corsola","Vaporeon","Whiscash","Sobble","Slowbro","Magikarp","Clawitzer"]
"Nidoking"	["Wishiwashi","Marshtomp","Brionne","Sharpedo","Cramorant","Empoleon","Cloyster","Oshawott","Palkia","Seel"]
"Vulpix"	["Totodile","Croconaw","Staryu","Lombre","Relicanth","Dracovish","Lotad","Gorebyss","Panpour","Basculin"]
"Ninetales"	["Mareanie","Slowking","Kabuto","Finneon","Shellder","Frillish","Drednaw","Pelipper","Tirtouga","Golisopod"]
"Diglett"	["Vaporeon","Mantine","Mareanie","Wishiwashi","Ducklett","Sobble","Totodile","Drednaw","Azumarill","Kyogre"]
"Dugtrio"	["Remoraid","Wishiwashi","Vaporeon","Seismitoad","Gastrodon","Relicanth","Froakie","Politoed","Keldeo","Barboach"]
"Growlithe"	["Volcanion","Psyduck","Wingull","Vaporeon","Prinplup","Corsola","Floatzel","Seadra","Tympole","Remoraid"]
"Arcanine"	["Palpitoad","Golisopod","Araquanid","Politoed","Binacle","Swanna","Squirtle","Chinchou","Barboach","Whiscash"]
"Geodude"	["Surskit","Wartortle","Corphish","Palpitoad","Omastar","Froakie","Quagsire","Kyogre","Gorebyss","Mantine"]
"Graveler"	["Golisopod","Golduck","Shellder","Jellicent","Binacle","Squirtle","Prinplup","Tapu Fini","Omastar","Vaporeon"]
"Golem"	["Gyarados","Horsea","Cloyster","Sharpedo","Carracosta","Gastrodon","Kingdra","Alomomola","Magikarp","Drizzile"]
"Ponyta"	["Croconaw","Huntail","Oshawott","Poliwrath","Sealeo","Magikarp","Feraligatr","Frillish","Barboach","Lanturn"]
"Rapidash"	["Marshtomp","Qwilfish","Oshawott","Golisopod","Clawitzer","Wimpod","Finneon","Carvanha","Swampert","Mareanie"]
"Onix"	["Tapu Fini","Barboach","Wartortle","Bibarel","Popplio","Vaporeon","Octillery","Krabby","Croconaw","Marill"]
"Cubone"	["Mantine","Poliwhirl","Poliwag","Seadra","Frillish","Wailord","Krabby","Kabutops","Phione","Qwilfish"]
"Marowak"	["Oshawott","Tympole","Piplup","Quagsire","Finneon","Gastrodon","Lapras","Kingler","Luvdisc","Clamperl"]
"Rhyhorn"	["Lanturn","Seaking","Araquanid","Toxapex","Poliwhirl","Arctovish","Clauncher","Carracosta","Simipour","Quagsire"]
"Rhydon"	["Clawitzer","Poliwag","Barboach","Walrein","Gyarados","Prinplup","Poliwhirl","Whiscash","Omastar","Ludicolo"]
"Magmar"	["Wailord","Palkia","Seaking","Frogadier","Mantyke","Omastar","Seel","Brionne","Starmie","Wimpod"]
"Flareon"	["Remoraid","Marshtomp","Blastoise","Magikarp","Poliwrath","Mudkip","Slowpoke","Qwilfish","Lombre","Popplio"]
"Aerodactyl"	["Dewgong","Omastar","Azumarill","Quagsire","Wartortle","Jellicent","Skrelp","Sobble","Poliwrath","Omanyte"]
"Cyndaquil"	["Toxapex","Seadra","Araquanid","Octillery","Feraligatr","Dewpider","Corphish","Magikarp","Surskit","Golisopod"]
"Quilava"	["Carracosta","Clamperl","Lombre","Poliwrath","Tirtouga","Feraligatr","Wimpod","Gyarados","Ducklett","Omastar"]
"Typhlosion"	["Clamperl","Kingler","Bibarel","Squirtle","Slowbro","Kabuto","Tympole","Arrokuda","Qwilfish","Dewpider"]
"Sudowoodo"	["Cramorant","Bruxish","Starmie","Barbaracle","Bibarel","Barraskewda","Kingler","Wooper","Tentacruel","Shellder"]
"Shuckle"	["Dewott","Wimpod","Prinplup","Lanturn","Frillish","Wailmer","Piplup","Tentacool","Poliwhirl","Slowbro"]
"Slugma"	["Mareanie","Kabutops","Manaphy","Carvanha","Wartortle","Suicune","Frillish","Golisopod","Brionne","Lotad"]
"Magcargo"	["Croconaw","Lapras","Sharpedo","Vaporeon","Basculin","Popplio","Clauncher","Huntail","Brionne","Arrokuda"]
"Houndour"	["Alomomola","Staryu","Binacle","Carvanha","Mudkip","Wailmer","Kabutops","Relicanth","Wooper","Keldeo"]
"Houndoom"	["Huntail","Quagsire","Greninja","Manaphy","Sobble","Arrokuda","Gorebyss","Bibarel","Cloyster","Relicanth"]
"Phanpy"	["Sharpedo","Crawdaunt","Chinchou","Barraskewda","Clamperl","Brionne","Piplup","Lombre","Arrokuda","Tympole"]
"Donphan"	["Alomomola","Remoraid","Basculin","Arctovish","Seismitoad","Lombre","Tentacruel","Goldeen","Skrelp","Cloyster"]
"Magby"	["Barbaracle","Whiscash","Jellicent","Corsola","Clawitzer","Seaking","Lotad","Luvdisc","Mareanie","Wimpod"]
"Entei"	["Froakie","Wailmer","Tympole","Drizzile","Corphish","Cramorant","Pyukumuku","Ducklett","Clawitzer","Walrein"]
"Larvitar"	["Suicune","Staryu","Remoraid","Marill","Drednaw","Buizel","Panpour","Corphish","Mareanie","Kyogre"]
"Pupitar"	["Dewott","Lotad","Octillery","Frogadier","Sobble","Luvdisc","Psyduck","Gastrodon","Poliwag","Wingull"]
"Torchic"	["Wartortle","Tapu Fini","Marill","Marshtomp","Jellicent","Luvdisc","Wingull","Tentacool","Tirtouga","Toxapex"]
"Combusken"	["Shellder","Bibarel","Wimpod","Starmie","Barbaracle","Huntail","Lotad","Manaphy","Alomomola","Omastar"]
"Blaziken"	["Kingler","Gyarados","Greninja","Mantyke","Wailmer","Tapu Fini","Ducklett","Swanna","Huntail","Azumarill"]
"Nosepass"	["Wooper","Palpitoad","Kingler","Octillery","Swanna","Gyarados","Skrelp","Clamperl","Tentacool","Wimpod"]
"Numel"	["Poliwag","Dewpider","Clawitzer","Drizzile","Kingler","Dewott","Froakie","Oshawott","Azumarill","Popplio"]
"Camerupt"	["Barbaracle","Lotad","Swanna","Simipour","Frogadier","Shellos","Basculin","Corsola","Quagsire","Skrelp"]
"Torkoal"	["Tapu Fini","Slowbro","Araquanid","Drizzile","Palkia","Kingdra","Whiscash","Swampert","Keldeo","Barboach"]
"Trapinch"	["Starmie","Chinchou","Palpitoad","Bruxish","Wailord","Carvanha","Seaking","Shellos","Psyduck","Clawitzer"]
"Lunatone"	["Wailord","Froakie","Cloyster","Feraligatr","Dewgong","Clamperl","Seismitoad","Palpitoad","Primarina","Manaphy"]
"Solrock"	["Blastoise","Ducklett","Dewpider","Frillish","Corsola","Walrein","Clauncher","Popplio","Froakie","Azumarill"]
"Baltoy"	["Jellicent","Tentacool","Phione","Krabby","Golduck","Gastrodon","Huntail","Tirtouga","Tympole","Spheal"]
"Claydol"	["Blastoise","Froakie","Wimpod","Dewott","Lumineon","Toxapex","Seismitoad","Tympole","Squirtle","Corphish"]
"Anorith"	["Lotad","Walrein","Lombre","Corsola","Finneon","Simipour","Luvdisc","Wartortle","Froakie","Pelipper"]
"Armaldo"	["Floatzel","Gorebyss","Wimpod","Poliwrath","Seadra","Manaphy","Horsea","Azumarill","Politoed","Gastrodon"]
"Regirock"	["Totodile","Araquanid","Marill","Binacle","Seadra","Tapu Fini","Gyarados","Lapras","Ludicolo","Gastrodon"]
"Groudon"	["Marill","Clauncher","Chewtle","Walrein","Lanturn","Barbaracle","Magikarp","Staryu","Remoraid","Panpour"]
"Chimchar"	["Finneon","Tympole","Poliwag","Froakie","Mudkip","Cloyster","Sharpedo","Carracosta","Swanna","Inteleon"]
"Monferno"	["Toxapex","Brionne","Seaking","Carracosta","Seel","Walrein","Drednaw","Kyogre","Skrelp","Poliwrath"]
"Infernape"	["Inteleon","Seel","Wimpod","Mareanie","Wailmer","Tapu Fini","Tentacruel","Barbaracle","Luvdisc","Sobble"]
"Cranidos"	["Arrokuda","Brionne","Barraskewda","Kabutops","Luvdisc","Crawdaunt","Volcanion","Drizzile","Lumineon","Prinplup"]
"Rampardos"	["Gorebyss","Crawdaunt","Seaking","Octillery","Omanyte","Wailmer","Greninja","Chewtle","Prinplup","Lombre"]
"Bonsly"	["Panpour","Empoleon","Toxapex","Inteleon","Corsola","Golisopod","Wailmer","Manaphy","Whiscash","Tirtouga"]
"Hippopotas"	["Quagsire","Wooper","Frogadier","Tapu Fini","Huntail","Krabby","Magikarp","Manaphy","Golisopod","Sealeo"]
"Hippowdon"	["Simipour","Sobble","Wimpod","Araquanid","Staryu","Politoed","Corphish","Gastrodon","Bruxish","Magikarp"]
"Rhyperior"	["Cloyster","Inteleon","Starmie","Wailord","Surskit","Corphish","Araquanid","Gorebyss","Palpitoad","Barboach"]
"Magmortar"	["Greninja","Goldeen","Oshawott","Cloyster","Brionne","Pelipper","Poliwag","Lanturn","Wishiwashi","Marill"]
"Victini"	["Swampert","Mudkip","Barbaracle","Slowpoke","Kabuto","Wimpod","Golduck","Kingler","Azumarill","Remoraid"]
"Tepig"	["Starmie","Lombre","Simipour","Dewott","Shellder","Swanna","Walrein","Magikarp","Golduck","Binacle"]
"Pignite"	["Octillery","Marill","Poliwrath","Sobble","Kabutops","Clauncher","Wingull","Araquanid","Ludicolo","Tympole"]
"Emboar"	["Tympole","Araquanid","Croconaw","Poliwag","Shellder","Sobble","Sealeo","Kabutops","Huntail","Slowking"]
"Pansear"	["Binacle","Wishiwashi","Corphish","Alomomola","Greninja","Wooper","Kabuto","Clamperl","Quagsire","Volcanion"]
"Simisear"	["Jellicent","Marshtomp","Tentacruel","Carvanha","Wailmer","Dewott","Blastoise","Bruxish","Poliwag","Magikarp"]
"Roggenrola"	["Frillish","Seadra","Slowbro","Vaporeon","Relicanth","Staryu","Keldeo","Araquanid","Mantine","Kingler"]
"Boldore"	["Wishiwashi","Relicanth","Kabutops","Panpour","Basculin","Quagsire","Oshawott","Alomomola","Staryu","Magikarp"]
"Gigalith"	["Tentacruel","Marshtomp","Azumarill","Kabuto","Basculin","Samurott","Seadra","Frogadier","Chewtle","Omanyte"]
"Drilbur"	["Ludicolo","Seismitoad","Prinplup","Swampert","Finneon","Slowking","Ducklett","Gyarados","Blastoise","Totodile"]
"Sandile"	["Popplio","Marill","Wingull","Starmie","Bibarel","Arctovish","Vaporeon","Seaking","Palpitoad","Mantine"]
"Krokorok"	["Frogadier","Dewott","Bruxish","Alomomola","Omastar","Qwilfish","Krabby","Marill","Squirtle","Barraskewda"]
"Krookodile"	["Whiscash","Lapras","Samurott","Oshawott","Blastoise","Ducklett","Slowbro","Sealeo","Chinchou","Frillish"]
"Darumaka"	["Magikarp","Dewgong","Carracosta","Buizel","Politoed","Swampert","Volcanion","Whiscash","Araquanid","Lapras"]
"Darmanitan"	["Keldeo","Feraligatr","Lombre","Floatzel","Marill","Lumineon","Corsola","Brionne","Surskit","Mantine"]
"Dwebble"	["Gastrodon","Tapu Fini","Seaking","Jellicent","Carracosta","Slowking","Totodile","Swampert","Lotad","Cramorant"]
"Crustle"	["Crawdaunt","Inteleon","Sobble","Azumarill","Seismitoad","Remoraid","Feraligatr","Toxapex","Wooper","Samurott"]
"Archen"	["Primarina","Wartortle","Seel","Poliwhirl","Clawitzer","Barbaracle","Buizel","Clauncher","Dracovish","Wishiwashi"]
"Archeops"	["Brionne","Slowpoke","Pyukumuku","Popplio","Kingler","Barraskewda","Politoed","Bibarel","Clauncher","Lapras"]
"Litwick"	["Pelipper","Arrokuda","Golisopod","Horsea","Octillery","Barbaracle","Panpour","Remoraid","Tapu Fini","Pyukumuku"]
"Lampent"	["Wooper","Jellicent","Slowbro","Arctovish","Staryu","Palkia","Azumarill","Araquanid","Samurott","Floatzel"]
"Chandelure"	["Floatzel","Tentacool","Krabby","Sharpedo","Toxapex","Lanturn","Shellder","Drizzile","Buizel","Tapu Fini"]
"Stunfisk"	["Gastrodon","Tympole","Sharpedo","Suicune","Seadra","Pyukumuku","Binacle","Carvanha","Clamperl","Golisopod"]
"Golett"	["Poliwag","Keldeo","Seaking","Lumineon","Barboach","Dewpider","Slowpoke","Tapu Fini","Kingler","Shellder"]
"Golurk"	["Golduck","Chewtle","Squirtle","Basculin","Samurott","Seismitoad","Greninja","Cloyster","Jellicent","Popplio"]
"Heatmor"	["Starmie","Finneon","Arrokuda","Azumarill","Brionne","Seismitoad","Prinplup","Arctovish","Phione","Primarina"]
"Terrakion"	["Seel","Volcanion","Totodile","Clauncher","Oshawott","Quagsire","Bibarel","Dewott","Lotad","Panpour"]
"Fennekin"	["Kyogre","Dewgong","Greninja","Lotad","Sharpedo","Primarina","Dracovish","Simipour","Manaphy","Poliwhirl"]
"Braixen"	["Walrein","Suicune","Barbaracle","Kabuto","Tapu Fini","Buizel","Swampert","Tentacool","Spheal","Oshawott"]
"Delphox"	["Krabby","Tympole","Seaking","Alomomola","Squirtle","Frogadier","Tapu Fini","Prinplup","Omanyte","Starmie"]
"Diggersby"	["Marshtomp","Slowbro","Clawitzer","Walrein","Tentacruel","Huntail","Crawdaunt","Frogadier","Seel","Greninja"]
"Litleo"	["Finneon","Lotad","Frillish","Marshtomp","Oshawott","Whiscash","Gastrodon","Slowbro","Magikarp","Seadra"]
"Pyroar"	["Lapras","Jellicent","Alomomola","Walrein","Frillish","Drizzile","Politoed","Relicanth","Whiscash","Inteleon"]
"Litten"	["Seaking","Qwilfish","Dewott","Barboach","Swampert","Lombre","Marill","Wailord","Brionne","Ludicolo"]
"Torracat"	["Marill","Ludicolo","Simipour","Seaking","Sealeo","Carracosta","Alomomola","Lotad","Luvdisc","Finneon"]
"Incineroar"	["Feraligatr","Corphish","Slowbro","Poliwag","Seaking","Starmie","Carracosta","Gorebyss","Simipour","Barboach"]
"Rockruff"	["Clauncher","Krabby","Crawdaunt","Azumarill","Goldeen","Panpour","Seismitoad","Dewgong","Drizzile","Wartortle"]
"Lycanroc"	["Wingull","Starmie","Bruxish","Seadra","Slowking","Golisopod","Barboach","Panpour","Politoed","Palkia"]
"Mudbray"	["Toxapex","Omastar","Volcanion","Mantyke","Alomomola","Drizzile","Carvanha","Oshawott","Azumarill","Seismitoad"]
"Mudsdale"	["Simipour","Sealeo","Croconaw","Qwilfish","Brionne","Lanturn","Gastrodon","Kyogre","Samurott","Greninja"]
"Sandygast"	["Surskit","Quagsire","Arctovish","Spheal","Binacle","Barboach","Wartortle","Skrelp","Sealeo","Psyduck"]
"Palossand"	["Kingler","Lumineon","Lotad","Feraligatr","Keldeo","Empoleon","Luvdisc","Araquanid","Wartortle","Primarina"]
"Minior"	["Oshawott","Vaporeon","Goldeen","Gorebyss","Buizel","Wartortle","Wimpod","Pelipper","Gastrodon","Feraligatr"]
"Blacephalon"	["Keldeo","Wishiwashi","Toxapex","Lotad","Slowpoke","Huntail","Clamperl","Squirtle","Swanna","Phione"]
"Scorbunny"	["Clawitzer","Skrelp","Goldeen","Feraligatr","Mantyke","Cramorant","Kingler","Kabutops","Piplup","Seismitoad"]
"Raboot"	["Wingull","Lanturn","Huntail","Blastoise","Suicune","Palkia","Oshawott","Kingler","Barbaracle","Clawitzer"]
"Cinderace"	["Politoed","Sealeo","Sharpedo","Gyarados","Barboach","Froakie","Volcanion","Surskit","Kyogre","Tapu Fini"]
"Rolycoly"	["Bruxish","Luvdisc","Prinplup","Quagsire","Barbaracle","Staryu","Pelipper","Pyukumuku","Alomomola","Crawdaunt"]
"Carkol"	["Blastoise","Toxapex","Popplio","Lanturn","Marill","Tapu Fini","Buizel","Bibarel","Carracosta","Wooper"]
"Coalossal"	["Krabby","Kabuto","Wartortle","Gastrodon","Samurott","Tentacruel","Greninja","Carvanha","Jellicent","Surskit"]
"Silicobra"	["Remoraid","Chewtle","Volcanion","Azumarill","Quagsire","Tapu Fini","Greninja","Ludicolo","Clamperl","Marshtomp"]
"Sandaconda"	["Crawdaunt","Gorebyss","Gastrodon","Kabutops","Cloyster","Slowpoke","Slowbro","Chewtle","Arctovish","Tentacruel"]
"Runerigus"	["Carvanha","Quagsire","Araquanid","Brionne","Poliwag","Sharpedo","Octillery","Kingdra","Omastar","Mantine"]
"Stonjourner"	["Octillery","Frillish","Buizel","Volcanion","Wimpod","Keldeo","Poliwrath","Gorebyss","Shellder","Psyduck"]
